perl-GraphicsMagick - Libraries and modules for access to GraphicsMagick from perl
perl-Magick - Libraries and modules for access to ImageMagick from perl
perl-libapreq2 - Perl interface to the Apache HTTP request library
apache2-mod_perl-devel - Files needed for building XS modules that use mod_perl
perl-Cyrus - Cyrus IMAP server utility Perl modules
perl-Geo-GDAL - Perl bindings for the GDAL library
perl-highlight - perl bindings for highlight source code to formatted text converter
perl-hivex - Perl bindings for hivex
perl-Sys-Guestfs - Perl bindings for libguestfs (Sys::Guestfs)
perl-prelude - Perl bindings for prelude
perl-stfl - Perl binding to stfl
perl-LockDev - Perl interface for the lockdev library
perl-SNMP - Perl SNMP Extension Module
perl-obexftp - Perl bindings for obexftp
perl-OSSP-uuid - perl bindings for Universally Unique Identifier library
perl-PCP-LogImport - Performance Co-Pilot (PCP) Perl bindings for importing external data into PCP archives
perl-PCP-MMV - Performance Co-Pilot (PCP) Perl bindings for PCP Memory Mapped Values
perl-PCP-PMDA - Performance Co-Pilot (PCP) Perl bindings and documentation
perl-PCP-common - Performance Co-Pilot (PCP) Perl common
perl-DBM - Perl modules for accessing DBM databases
perl-Unicode-Normalize - Unicode normalization forms
perl-base - Pathologically Eclectic Rubbish Lister
perl-devel - Perl header files and development modules
perl-threads - Perl thread modules
perl-AI-DecisionTree - Automatically Learns Decision Trees
perl-Acme-Damn - 'Unbless' Perl objects
perl-Algorithm-Combinatorics - Efficient generation of combinatorial sequences
perl-Alien-GMP - Build and install the GNU Multiple Precision library.
perl-Alien-Libxml2 - Install the C libxml2 library on your system
perl-Alien-cmake3 - Find or download or build cmake 3 or better
perl-Alien-wxWidgets - Alien-wxWidgets - building, finding and using wxWidgets binaries
perl-AnyEvent-XSPromises - Another Promises library, this time implemented in XS for performance
perl-AptPkg - Perl interface to libapt-pkg
perl-Array-RefElem - Set up array elements as aliases
perl-Async-Interrupt - Allow C/XS libraries to interrupt perl asynchronously
perl-Audio-CD - Perl interface to libcdaudio
perl-Audio-FLAC-Header - interface to FLAC header metadata.
perl-Audio-PortAudio - Perl portable interface for audio IO using libportaudio
perl-Authen-DecHpwd - DEC VMS password hashing
perl-Authen-PAM - Perl interface to PAM library
perl-Authen-Smb - Perl extension to authenticate against an SMB server
perl-B-C - Perl compiler's C backend
perl-B-COW - B::COW additional B helpers to check COW status
perl-B-Flags - B::Flags - Friendlier flags for B
perl-B-Hooks-OP-Annotation - Annotate and delegate hooked OPs
perl-B-Hooks-OP-Check - Wrap OP check callbacks
perl-B-Hooks-Parser - Interface to perl's parser variables
perl-B-Utils - Helper functions for op tree manipulation
perl-BDB - Asynchronous Berkeley DB access
perl-BSD-Resource - BSD process resource limit and priority functions
perl-BSD-arc4random - This module provides a Perl API for the BSDs' arc4random(3) suite of functions
perl-BerkeleyDB - Perl bindings to Berkeley DB version 2.x and greater
perl-Bit-Vector - Efficient bit vector, set of integers and "big int" math library
perl-Boost-Geometry-Utils - Boost::Geometry::Utils Perl module
perl-CBOR-XS - Concise Binary Object Representation (CBOR, RFC7049)
perl-CDB_File - Perl extension for access to cdb databases
perl-CGI-Deurl-XS - Fast decoder for URL parameter strings
perl-CGI-SpeedyCGI - Speed up perl scripts by running them persistently
perl-CSS-Minifier-XS - XS based CSS minifier
perl-Cache-FastMmap - Uses an mmap'ed file to act as a shared memory interprocess cache
perl-Cache-Memcached-Fast - Perl client for memcached
perl-Cairo - Perl interface to the cairo vector graphics library
perl-Cairo-devel - Perl interface to the cairo vector graphics library
perl-Cairo-GObject - Integrate Cairo into the Glib type system
perl-Cassandra-Client - Perl interface to Cassandra's native protocol
perl-Cellular-Automata-Wolfram - perl module Cellular-Automata-Wolfram
perl-Cflow - Find flows in raw IP flow files
perl-Class-C3-XS - XS speedups for Class::C3
perl-Class-Load-XS - XS implementation of parts of Class::Load
perl-Class-MethodMaker - Easy building of Perl Classes
perl-Class-XSAccessor - Generate fast XS accessors without runtime compilation
perl-Clone - Recursively copy Perl datatypes
perl-CommonMark - Interface to the CommonMark C library
perl-Compiler-Lexer - Lexical Analyzer for Perl5
perl-Compress-Bzip2 - Interface to Bzip2 compression library
perl-Compress-LZ4 - Perl interface to the LZ4 (de)compressor
perl-Compress-LZF - Extremely light-weight Lempel-Ziv-Free compression
perl-Compress-LZO - Perl interface to the LZO compression library
perl-Compress-Raw-Bzip2 - Low-level interface to the bzip2 compression library
perl-Compress-Raw-Zlib - Low-level interface to the zlib compression library
perl-Compress-Snappy - Perl interface to Google's Snappy (de)compressor
perl-Convert-UUlib - Perl interface to the uulib library (a.k.a. uudeview/uuenview)
perl-Cookie-Baker-XS - boost Cookie::Baker's crush_cookie
perl-Coro - The only real threads in perl
perl-Cpanel-JSON-XS - JSON::XS for Cpanel, fast and correct serialising, also for 5.6.2
perl-Crypt-Blowfish - Perl Blowfish encryption module
perl-Crypt-CAST5 - CAST5 block cipher
perl-Crypt-Curve25519 - Generate shared secret using elliptic-curve Diffie-Hellman function
perl-Crypt-DES - Perl DES encryption module
perl-Crypt-DH-GMP - Crypt::DH Using GMP Directly
perl-Crypt-Ed25519 - bare-bones Ed25519 public key signing/verification system
perl-Crypt-Eksblowfish - Eksblowfish block cipher
perl-Crypt-IDEA - Perl interface to IDEA block cipher
perl-Crypt-MySQL - perl module Crypt-MySQL
perl-Crypt-OpenBSD-Blowfish - This module provides an interface to the OpenBSD Blowfish cipher implementation
perl-Crypt-OpenSSH-ChachaPoly - This module serves as a wrapper to the OpenSSH Chacha20 and Poly1305 functions
perl-Crypt-OpenSSL-AES - XS-wrapper around OpenSSL's AES library
perl-Crypt-OpenSSL-Bignum - Perl module for OpenSSL's multiprecision integer arithmetic
perl-Crypt-OpenSSL-DSA - Digital Signature Algorithm using OpenSSL
perl-Crypt-OpenSSL-EC - Perl extension for OpenSSL EC (Elliptic Curves) library
perl-Crypt-OpenSSL-ECDSA - Perl extension for OpenSSL ECDSA (Elliptic Curve Digital Signature Algorithm)
perl-Crypt-OpenSSL-RSA - RSA encoding and decoding, using the openSSL libraries
perl-Crypt-OpenSSL-Random - Routines for accessing the OpenSSL pseudo-random number generator
perl-Crypt-OpenSSL-X509 - Perl interface to OpenSSL for X509
perl-Crypt-RIPEMD160 - Perl extension for the RIPEMD-160 Hash function
perl-Crypt-Rijndael - Crypt::CBC compliant Rijndael encryption module
perl-Crypt-SSLeay - OpenSSL glue that provides LWP https support
perl-Crypt-Twofish - The Twofish Encryption Algorithm
perl-Crypt-UnixCrypt_XS - perl module Crypt-UnixCrypt_XS
perl-CryptX - Crypto toolkit with multiple ciphers, hash functions and other
perl-Curses - Terminal screen handling and optimization
perl-DBD-InterBase - DBI driver for Firebird and InterBase RDBMS server
perl-DBD-MariaDB - MariaDB driver for DBI interface in Perl
perl-DBD-ODBC - Perl DBD module for interfacing with ODBC databases
perl-DBD-Pg - PostgreSQL database driver for the DBI module
perl-DBD-SQLite - SQLite driver for DBI interface in Perl
perl-DBD-Sybase - Sybase database driver (TDS protocol) for the DBI module
perl-DBD-mysql - MySQL driver for DBI interface in Perl
perl-DBD-DBM - DBI driver for DBM and MLDBM files
perl-DBD-File - Base class for writing DBI drivers
perl-DBD-Gofer - A stateless-proxy driver for communicating with a remote DBI
perl-DBD-Proxy - A proxy driver for the DBI
perl-DBI - Database independent interface for Perl
perl-DBI-Gofer - DBI::Gofer proxy server classes
perl-DBI-Profile - Performance profiling and benchmarking for the DBI
perl-DBI-ProxyServer - A server for the DBD::Proxy driver
perl-DBI-devel - DBI development files
perl-Data-Array2ArrayMap-Hash-XSTree - a Perl interface to multiple tree data structures.
perl-Data-Array2ArrayMap-SDB - Perl && C++/XS module to access static db (SDB) files.
perl-Data-BitStream-XS - A class implementing a stream of bits and coding methods
perl-Data-Clone - Polymorphic data cloning
perl-Data-Dump-Streamer - Accurately serialize a data structure as Perl code
perl-Data-MessagePack - MessagePack serialising/deserialising
perl-Data-Peek - Collection of low-level debug facilities
perl-Data-Structure-Util - Change nature of data within a structure
perl-Data-UUID - Perl extension for generating Globally/Universally Unique Identifiers (GUIDs/UUIDs)
perl-Data-Util - A selection of utilities for data and data types
perl-Date-Calc-XS - XS wrapper and C library plug-in for Date::Calc
perl-Date-Pcalc - Gregorian calendar date calculations
perl-Date-Simple - a simple date object
perl-DateTime - DateTime base objects
perl-Devel-CallChecker - custom op checking attached to subroutines
perl-Devel-CallParser - custom parsing attached to subroutines
perl-Devel-Caller - Meatier versions of caller()
perl-Devel-Callsite - Get caller return OP address and Perl interpreter context
perl-Devel-Cover - Code coverage metrics for Perl
perl-Devel-DProf - A DEPRECATED Perl code profiler
perl-Devel-Declare - Adding keywords to perl, in perl
perl-Devel-FindRef - Where is that reference to my variable hiding?
perl-Devel-Leak - Utility for looking for perl objects that are not reclaimed
perl-Devel-LexAlias - Alias lexical variables
perl-Devel-Mallinfo - Get mallinfo() malloc memory stats
perl-Devel-NYTProf - Powerful fast feature-rich perl source code profiler
perl-Devel-Refcount - Obtain the REFCNT value of a referent
perl-Devel-Size - Perl extension for finding the memory usage of Perl variables
perl-Device-SerialPort - Linux/POSIX emulation of Win32::SerialPort functions
perl-Digest-BMW - Perl interface to the Blue Midnight Wish digest algorithm
perl-Digest-CRC - Digest::CRC - Generic CRC functions
perl-Digest-GOST - Perl interface to the GOST R 34.11-94 digest algorithm
perl-Digest-Haval256 - A 5-round, 256-bit one-way hash function
perl-Digest-JHash - Perl extension for 32 bit Jenkins Hashing Algorithm
perl-Digest-MD2 - Perl interface to the MD2 Algorithm
perl-Digest-MD4 - Perl interface to the MD4 Algorithm
perl-Digest-SHA - Perl extension for SHA-1/224/256/384/512
perl-Digest-SHA1 - Perl interface to the SHA1 algorithm
perl-Digest-SHA3 - Perl extension for SHA-3
perl-Digest-Whirlpool - A 512-bit, collision-resistant, one-way hash function
perl-EV - Perl interface to libev, a high performance full-featured event loop
perl-EV-ADNS - Perl module for lightweight asynchronous DNS queries using EV and libadns
perl-Email-Address-XS - Parse and format RFC 2822 email addresses and groups
perl-Enbugger - "Enables the debugger at runtime"
perl-Encode - Character encodings
perl-Encode-CN - China-based Chinese Encodings
perl-Encode-JP - Japanese Encodings
perl-Encode-KR - Korean Encodings
perl-Encode-TW - Taiwan-based Chinese Encodings
perl-Encode-devel - Perl Encode Module Generator
perl-Encode-Detect - Perl module that detects the encoding of data
perl-Encode-EUCJPASCII - EucJP-ascii - An eucJP-open mapping
perl-Encode-HanExtra - Extra sets of Chinese encodings
perl-Encode-JIS2K - JIS X 0212 (aka JIS 2000) encodings
perl-Encode-TECkit - TECkit Encode interface
perl-Event - Event loop processing
perl-Event-Lib - Perl extentions for event-based programming
perl-FCGI - Fast CGI module for perl
perl-File-FcntlLock - File locking with fcntl(2)
perl-File-LibMagic - Perl wrapper for libmagic
perl-File-Map - Memory mapping made simple and safe
perl-File-Sync - Perl access to fsync() and sync() function calls
perl-Filesys-Df - Perl extension for filesystem disk space information
perl-Filesys-Statvfs - Perl extension for statvfs() and fstatvfs()
perl-Filter - Source Filters
perl-Function-Parameters - subroutine definitions with parameter lists
perl-Fuse - Write filesystems in Perl using FUSE
perl-GD - Perl interface to the GD graphics library
perl-GSSAPI - Perl extension providing access to the GSSAPIv2 library
perl-Geo-IP - Look up country by IP Address
perl-Glib - Perl module for the glib-2.x library
perl-Glib-devel - Perl module for the glib-2.x library (development files)
perl-Glib-Object-Introspection - Dynamically create Perl language bindings
perl-Gnome2 - Gnome2 Perl module
perl-Gnome2-devel - Gnome2 Perl module (development files)
perl-Gnome2-Canvas - Gnome2-Canvas Perl module
perl-Gnome2-Canvas-devel - Gnome2-Canvas Perl module (development files)
perl-Gnome2-GConf - Perl wrappers for the GConf configuration engine
perl-Gnome2-VFS - Gnome2-VFS Perl module
perl-Gnome2-VFS-devel - Gnome2-VFS Perl module (development files)
perl-Gnome2-Wnck - Perl interface to the Window Navigator Construction Kit
perl-Goo-Canvas - Perl interface to the GooCanvas
perl-GooCanvas2-CairoTypes - Bridge between GooCanvas2 and Cairo types
perl-Graph-Layout-Aesthetic - A module for laying out graphs
perl-Graphics-TIFF - Perl extension for the libtiff library
perl-Gtk2 - Perl bindings to the gtk+-2.x library
perl-Gtk2-devel - Perl bindings to the gtk+-2.x library (development files)
perl-Gtk2-GladeXML - Create user interfaces directly from Glade XML files
perl-Gtk2-ImageView - Perl bindings for the GtkImageView widget
perl-Gtk2-Sexy - Perl interface to the sexy widget collection
perl-Gtk2-Spell - Perl bindings for GtkSpell with Gtk2
perl-Gtk2-TrayIcon - Gtk2-TrayIcon Perl module
perl-Gtk2-Unique - Use single instance applications
perl-Guard - Safe cleanup blocks for Perl
perl-HTML-Escape - Extremely fast HTML escape
perl-HTML-Parser - Parsing and extracting information from HTML documents
perl-HTML-Template-Pro - Perl+C/XS module to produce HTML from HTML Template files.
perl-HTML-Tidy - HTML validation in a Perl object
perl-HTTP-Parser-XS - A fast, primitive HTTP request parser
perl-Hash-FieldHash - Lightweight field hash implementation
perl-IO-AIO - Asynchronous Input/Output
perl-IO-Epoll - Scalable IO Multiplexing for Linux
perl-IO-FDPass - pass a file descriptor over a socket
perl-IO-Interface - extention for IO::Socket
perl-IO-Socket-Multicast - Send and receive multicast messages
perl-IO-Tty - interface to pseudo tty's
perl-IPC-Mmap - Minimal unified mmap for POSIX and Win32
perl-IPC-ShareLite - Light-weight interface to shared memory
perl-Image-PNG-Libpng - Perl interface to libpng
perl-Image-Sane - Perl extension for the SANE (Scanner Access Now Easy) Project
perl-Imager - Perl module for generating 24 bit Images
perl-Inline-Python - Write Perl subs and classes in Python
perl-JSON-DWIW - Flexible and fast JSON converter for Perl
perl-JSON-Parse - Read JSON into a Perl variable
perl-JSON-XS - JSON serialising/deserialising, done correctly and fast
perl-JSON-XS3 - JSON serialising/deserialising, done correctly and fast
perl-JavaScript-Minifier-XS - XS based JavaScript minifier
perl-JavaScript-V8 - JavaScript::V8 - Perl interface to the V8 JavaScript engine
perl-KyotoCabinet - a straightforward implementation of DBM
perl-Lchown - Perl interface to the lchown(2) system call
perl-Lexical-SealRequireHints - Prevent leakage of lexical hints
perl-Lexical-Var - Static variables without name space pollution
perl-Linux-Inotify2 - Scalable directory/file change notification
perl-Linux-Personality - Perl interface to the personality(2) Linux system call
perl-Linux-Pid - Get the native PID and the PPID on Linux
perl-List-MoreUtils-XS - Provide compiled List::MoreUtils functions
perl-Locale-Hebrew - Bidirectional Hebrew support
perl-Locale-gettext - Gettext routines for Perl
perl-MIME-Explode - Perl extension for explode MIME messages
perl-MRO-Define - Define your own method resolution order
perl-Mail-Transport-Dbx - Parse Outlook Express mailboxes
perl-Marpa-R2 - Release 2 of Marpa
perl-Math-BigInt-FastCalc - XS implementation of arbitrary size integer math
perl-Math-BigInt-GMP - Use the GMP library for Math::BigInt routines
perl-Math-BigInteger - Math::BigInteger - arbitrary length integer extension module for Perl
perl-Math-Decimal64 - (alpha) perl interface to C's _Decimal64 operations.
perl-Math-FFT - Perl extension for Fast Fourier Transforms
perl-Math-Factor-XS - Factorize numbers and calculate matching multiplications
perl-Math-GMP - High speed arbitrary size integer math
perl-Math-GMPf - perl interface to the GMP library's floating point (mpf) functions..
perl-Math-GMPn - Fixed length integer arithmetic.
perl-Math-GMPq - perl interface to the GMP library's rational (mpq) functions..
perl-Math-GMPz - perl interface to the GMP library's integer (mpz) functions..
perl-Math-Geometry-Voronoi - Compute Voronoi diagrams from sets of points
perl-Math-Int64 - Perl module to manipulate 64 bits integers
perl-Math-Libm - Perl extension for the C math library, libm
perl-Math-LongDouble - perl module Math-LongDouble
perl-Math-MPFR - perl interface to the MPFR (floating point) library..
perl-Math-Pari - Perl interface to PARI
perl-Math-Prime-Util - Utilities related to prime numbers, including fast sieves and factoring
perl-Math-Prime-Util-GMP - Utilities related to prime numbers, using GMP
perl-Math-Prime-XS - Detect and calculate prime numbers with deterministic tests
perl-Math-Random-ISAAC-XS - C implementation of the ISAAC PRNG algorithm
perl-Mcrypt - Mcrypt - Perl extension for the Mcrypt cryptography library
perl-Moose - A postmodern object system for Perl 5
perl-MooseX-Role-WithOverloading - Roles which support overloading
perl-Mouse - Moose minus the antlers
perl-Mozilla-LDAP - LDAP Perl module that wraps the Mozilla C SDK
perl-Net-ARP - Perl extension for creating ARP packets
perl-Net-CUPS - Perl interface to the Common Unix Printing System API
perl-Net-DBus - Perl extension for the DBus message system
perl-Net-DNS-SEC - Net-DNS-SEC module for perl
perl-Net-DNS-ToolKit - Tools for working with DNS packets
perl-Net-IDN-Encode - Encoding and decoding of Internationalized Domain Names
perl-Net-LibAsyncNS - a Perl wrapper around F<libasyncns>
perl-Net-LibIDN - Perl bindings for GNU LibIDN
perl-Net-Libdnet - Binding for Dug Song's libdnet
perl-Net-Patricia - Patricia Trie perl module for fast IP address lookups
perl-Net-Pcap - Interface to pcap(3) LBL packet capture library
perl-Net-RawIP - Perl extension to manipulate raw IP packets
perl-Net-SSH-Perl - Perl client interface to SSH
perl-Net-SSH2 - Support for the SSH 2 protocol via libssh2
perl-Net-SSLeay - Perl extension for using OpenSSL
perl-NetAddr-IP - Manages IP addresses and subnets
perl-Newt - Perl bindings for the Newt library
perl-OpenGL - Perl bindings to OpenGL API
perl-PAR-Packer - Perl module to generate stand-alone executables and ".par" archives
perl-PAR-Packer-scripts - PAR:Packer scripts
perl-PDL - The Perl Data Language
perl-PDL-tests - Tests for perl-PDL
perl-POSIX-1003 - POSIX::1003, alternative for POSIX in core
perl-POSIX-Regex - OO interface for the gnu regex engine
perl-POSIX-strptime - Perl extension to the POSIX date parsing strptime(3) function
perl-PPI-XS - Perl module with XS acceleration for PPI
perl-PPerl - Make perl scripts persistent in memory
perl-Package-Stash-XS - Faster and more correct implementation of the Package::Stash API
perl-PadWalker - Inspect lexical variables in any subroutine which called you
perl-Pango - Layout and render international text
perl-Pango-devel - Layout and render international text
perl-Params-Classify - Argument type classification
perl-Params-Util - Simple standalone param-checking functions
perl-Params-Validate - Validate method/function parameters
perl-Parse-ExuberantCTags - Efficiently parse exuberant ctags files
perl-Passwd-Linux - Perl module for manipulating the passwd and shadow files
perl-Perl-Destruct-Level - Allows you to change perl's internal destruction level
perl-PerlIO-Layers - Querying your file handle capabilities
perl-PerlIO-Util - A selection of general PerlIO utilities
perl-PerlIO-eol - PerlIO layer for normalizing line endings
perl-PerlIO-gzip - A layer for the PerlIO system to transparently gzip/gunzip files
perl-PerlIO-utf8_strict - fast and correct UTF-8 IO module
perl-PerlX-Maybe-XS - XS backend for PerlX::Maybe
perl-Pg - PostgreSQL database native Perl driver
perl-Pg-PQ - Perl wrapper for PostgreSQL libpq
perl-Prima - Perl graphic toolkit
perl-Prima-Test - Test tools for Prima Perl graphic toolkit
perl-Proc-FastSpawn - fork+exec, or spawn, a subprocess as quickly as possible
perl-Proc-ProcessTable - Perl extension to access the unix process table
perl-Proc-Wait3 - Perl wrapper around the wait3(1) system call
perl-Quota - Perl interface to file system quotas
perl-RPM - Native bindings to the RPM Package Manager API
perl-RPM2 - Perl bindings for the RPM Package Manager API
perl-Readonly-XS - Companion module for perl-Readonly
perl-Ref-Util-XS - XS implementation for Ref::Util Perl module
perl-Module-Build-SDL - Module::Build subclass for building SDL apps/games
perl-SDL - Simple DirectMedia Layer for Perl
perl-SDL-pods - POD documentation for Simple DirectMedia Layer for Perl
perl-SGML-Parser-OpenSP - Parse SGML documents using OpenSP
perl-Sane - Perl extension for the SANE (Scanner Access Now Easy) Project
perl-Scalar-String - string aspects of scalars
perl-Scalar-Util-Instance - Generates and installs is-a predicates
perl-Scope-Upper - Act on upper scopes
perl-Search-Xapian - Xapian perl bindings
perl-Sereal-Decoder - Fast, compact, powerful binary deserialization
perl-Sereal-Encoder - Fast, compact, powerful binary serialization
perl-Set-Object - Unordered collections (sets) of Perl Objects
perl-Socket-MsgHdr - Sendmsg, recvmsg and ancillary data operations
perl-Socket-Netlink - interface to Linux's PF_NETLINK socket family
perl-Socket6 - Socket6 Perl module
perl-Sort-Key - Fastest way to sort anything in Perl
perl-Statistics-CaseResampling - Perl module for resampling and calculation of medians with confidence intervals
perl-String-Approx - Perl extension for approximate matching (fuzzy matching)
perl-String-CRC - Cyclic redundency check generation
perl-String-CRC32 - Cyclic redundency check generation
perl-String-Compare-ConstantTime - Timing side-channel protected string compare
perl-String-Similarity - Calculates the similarity of two strings
perl-Sub-Attribute - Reliable subroutine attribute handlers
perl-Sub-Current - Perl module to get the current subroutine
perl-Sub-Identify - Retrieve names of code references
perl-Sub-Name - (re)name a sub
perl-Sys-CPU - Getting CPU information
perl-Sys-CPUtime - Perl extension for SIGXCPU workaround
perl-Sys-Hostname-FQDN - Get the short or long hostname
perl-Sys-MemInfo - Memory information as Perl module
perl-Sys-Mmap - Perl module to use mmap to map in a file as a Perl variable
perl-Sys-Virt - Represent and manage a libvirt hypervisor connection
perl-Template - Perl Template Toolkit
perl-Term-ReadLine-Gnu - Perl interface to the GNU Readline library
perl-Term-Size - Perl module for get the size of the terminal
perl-TermReadKey - simple control over terminal driver modes
perl-Test-LeakTrace - Trace memory leaks
perl-Test-MockRandom - Replaces random number generation with non-random number generation
perl-Test-Taint - Checks for taintedness of variables
perl-Text-Aspell - Perl interface to the GNU Aspell library
perl-Text-BibTeX - Interface to read and parse BibTeX files
perl-Text-Bidi - Unicode bidi algorithm for Perl using libfribidi
perl-Text-CHM - Perl module for handling Compiled HtmlHelp Files (.chm)
perl-Text-CSV_XS - Comma-separated values manipulation routines
perl-Text-CharWidth - Get number of occupied columns of a string on terminal
perl-Text-ExtractWords - Perl extension for extract words from strings
perl-Text-Iconv - Perl interface to iconv(3) codeset conversion function
perl-Text-Kakasi - Perl frontend to kakasi
perl-Text-Markdown-Hoedown - hoedown for Perl5
perl-Text-Ngram - Ngram analysis of text
perl-Text-Soundex - Implementation of the Soundex algorithm as described by Knuth
perl-Text-Xslate - Text::Xslate - Scalable template engine for Perl5
perl-Thread-SigMask - Thread specific signal masks
perl-Tie-CArray - space-efficient, typed, external C Arrays
perl-Time-Format_XS - Companion module for Time::Format, to speed up time formatting
perl-Time-Moment - Represents a date and time of day with an offset from UTC
perl-Time-Piece - Object Oriented time objects
perl-Time-TZOffset - Show timezone offset strings like +0900
perl-Time-Warp - Control over the flow of time
perl-Tk - Perl modules providing the Tk graphics library
perl-Tk-demos - Perl modules providing the Tk graphics library
perl-Tk-devel - Perl modules providing the Tk graphics library
perl-Tk-TableMatrix - The Tk::TableMatrix Widget
perl-Tk-TableMatrix-devel - The Tk::TableMatrix Widget
perl-TokyoCabinet - TokyoCabinet - Perl module
perl-URI-Escape-XS - Drop-In replacement for URI::Escape
perl-URI-UTF8-Punycode - Punycode conversion of UTF-8 string.
perl-URL-Encode-XS - XS implementation of URL::Encode
perl-UUID - DCE compatible Universally Unique Identifier library for Perl
perl-Unicode-CaseFold - Unicode case-folding for case-insensitive lookups.
perl-Unicode-CheckUTF8 - Checks if scalar is valid UTF-8
perl-Unicode-Collate - Unicode Collation Algorithm
perl-Unicode-LineBreak - UAX #14 Unicode Line Breaking Algorithm
perl-Unicode-Map - Maps charsets from and to utf16 unicode
perl-Unicode-Map8 - Perl module to represent mapping tables between 8-bit chars and Unicode
perl-Unicode-String - Perl module to represent strings of Unicode chars
perl-Unicode-UTF8 - Encoding and decoding of UTF-8 encoding form
perl-Unix-Mknod - Perl extension for mknod, major, minor, and makedev
perl-Unix-Syslog - Perl interface to the UNIX system logger
perl-Variable-Magic - Associate user-defined magic to variables from Perl
perl-WWW-Curl - Perl extension interface for libcurl
perl-WWW-Form-UrlEncoded - parser and builder for application/x-www-form-urlencoded
perl-WWW-Form-UrlEncoded-XS - XS implementation of parser and builder for application/x-www-form-urlencoded
perl-Want - A generalisation of "wantarray"
perl-Wx - wxPerl - Perl bindings for wxWindows
perl-Wx-devel - Wx Perl development files
perl-Wx-GLCanvas - Interface to wxWidgets' OpenGL canvas
perl-Wx-Scintilla - Wx::Scintilla - Scintilla source code editing component for wxWidgets
perl-X-Osd - Perl extension to the X On Screen Display library (xosd)
perl-X11-GUITest - Collection of functions for X11 GUI testing/interaction
perl-X11-Xlib - Low-level access to the X11 library
perl-XML-Bare - A minimal XML parser / schema checker / pretty-printer using C internally
perl-XML-LibXML - Perl binding for libxml2
perl-XML-LibXSLT - Perl interface to the Gnome libxslt library
perl-XML-Parser - Perl module for parsing XML files
perl-XML-SAX-ExpatXS - Perl SAX 2 XS extension to Expat parser
perl-YAML-LibYAML - Perl YAML Serialization using XS and libyaml
perl-YAML-LibYAML-API - Wrapper around the C libyaml library
perl-YAML-Syck - Fast, lightweight YAML loader and dumper
perl-autobox - Perl interface to call methods on native types
perl-autovivification - Lexically disable autovivification
perl-common-sense - "Common sense" Perl defaults
perl-constant-lexical - Perl pragma to declare lexical compile-time constants
perl-forks - Drop-in replacement for Perl threads using fork()
perl-libintl - High-Level Interface to Uniforum Message Translation
perl-pcsc - Perl interface to the PC/SC smart card library
perl-ph - Perl *.ph files
perl-qa-cache - Simple and efficient cache for memoization
perl-qa-rpmelfsym - Faster rpmelfsym(1) and bad_elf_symbols implementation
perl-Razor - Perl modules for Razor
perl-RRD - Round Robin Database perl modules
perl-X2Go-Server-DB - Perl X2Go::Server::DB package
i586-perl-AI-DecisionTree - Automatically Learns Decision Trees
i586-perl-Acme-Damn - 'Unbless' Perl objects
i586-perl-Algorithm-Combinatorics - Efficient generation of combinatorial sequences
i586-perl-AnyEvent-XSPromises - Another Promises library, this time implemented in XS for performance
i586-perl-AptPkg - Perl interface to libapt-pkg
i586-perl-Array-RefElem - Set up array elements as aliases
i586-perl-Async-Interrupt - Allow C/XS libraries to interrupt perl asynchronously
i586-perl-Audio-CD - Perl interface to libcdaudio
i586-perl-Audio-FLAC-Header - interface to FLAC header metadata.
i586-perl-Audio-PortAudio - Perl portable interface for audio IO using libportaudio
i586-perl-Authen-DecHpwd - DEC VMS password hashing
i586-perl-Authen-PAM - Perl interface to PAM library
i586-perl-Authen-Smb - Perl extension to authenticate against an SMB server
i586-perl-B-C - Perl compiler's C backend
i586-perl-B-COW - B::COW additional B helpers to check COW status
i586-perl-B-Flags - B::Flags - Friendlier flags for B
i586-perl-B-Hooks-OP-Annotation - Annotate and delegate hooked OPs
i586-perl-B-Hooks-OP-Check - Wrap OP check callbacks
i586-perl-B-Hooks-Parser - Interface to perl's parser variables
i586-perl-B-Utils - Helper functions for op tree manipulation
i586-perl-BDB - Asynchronous Berkeley DB access
i586-perl-BSD-Resource - BSD process resource limit and priority functions
i586-perl-BSD-arc4random - This module provides a Perl API for the BSDs' arc4random(3) suite of functions
i586-perl-BerkeleyDB - Perl bindings to Berkeley DB version 2.x and greater
i586-perl-Bit-Vector - Efficient bit vector, set of integers and "big int" math library
i586-perl-Boost-Geometry-Utils - Boost::Geometry::Utils Perl module
i586-perl-CBOR-XS - Concise Binary Object Representation (CBOR, RFC7049)
i586-perl-CDB_File - Perl extension for access to cdb databases
i586-perl-CGI-Deurl-XS - Fast decoder for URL parameter strings
i586-perl-CSS-Minifier-XS - XS based CSS minifier
i586-perl-Cache-FastMmap - Uses an mmap'ed file to act as a shared memory interprocess cache
i586-perl-Cache-Memcached-Fast - Perl client for memcached
i586-perl-Cairo - Perl interface to the cairo vector graphics library
i586-perl-Cairo-GObject - Integrate Cairo into the Glib type system
i586-perl-Cassandra-Client - Perl interface to Cassandra's native protocol
i586-perl-Cellular-Automata-Wolfram - perl module Cellular-Automata-Wolfram
i586-perl-Cflow - Find flows in raw IP flow files
i586-perl-Class-C3-XS - XS speedups for Class::C3
i586-perl-Class-Load-XS - XS implementation of parts of Class::Load
i586-perl-Class-MethodMaker - Easy building of Perl Classes
i586-perl-Class-XSAccessor - Generate fast XS accessors without runtime compilation
i586-perl-Clone - Recursively copy Perl datatypes
i586-perl-CommonMark - Interface to the CommonMark C library
i586-perl-Compiler-Lexer - Lexical Analyzer for Perl5
i586-perl-Compress-Bzip2 - Interface to Bzip2 compression library
i586-perl-Compress-LZ4 - Perl interface to the LZ4 (de)compressor
i586-perl-Compress-LZF - Extremely light-weight Lempel-Ziv-Free compression
i586-perl-Compress-LZO - Perl interface to the LZO compression library
i586-perl-Compress-Raw-Bzip2 - Low-level interface to the bzip2 compression library
i586-perl-Compress-Raw-Zlib - Low-level interface to the zlib compression library
i586-perl-Compress-Snappy - Perl interface to Google's Snappy (de)compressor
i586-perl-Convert-UUlib - Perl interface to the uulib library (a.k.a. uudeview/uuenview)
i586-perl-Cookie-Baker-XS - boost Cookie::Baker's crush_cookie
i586-perl-Coro - The only real threads in perl
i586-perl-Cpanel-JSON-XS - JSON::XS for Cpanel, fast and correct serialising, also for 5.6.2
i586-perl-Crypt-Blowfish - Perl Blowfish encryption module
i586-perl-Crypt-CAST5 - CAST5 block cipher
i586-perl-Crypt-Curve25519 - Generate shared secret using elliptic-curve Diffie-Hellman function
i586-perl-Crypt-DES - Perl DES encryption module
i586-perl-Crypt-DH-GMP - Crypt::DH Using GMP Directly
i586-perl-Crypt-Ed25519 - bare-bones Ed25519 public key signing/verification system
i586-perl-Crypt-Eksblowfish - Eksblowfish block cipher
i586-perl-Crypt-IDEA - Perl interface to IDEA block cipher
i586-perl-Crypt-MySQL - perl module Crypt-MySQL
i586-perl-Crypt-OpenBSD-Blowfish - This module provides an interface to the OpenBSD Blowfish cipher implementation
i586-perl-Crypt-OpenSSH-ChachaPoly - This module serves as a wrapper to the OpenSSH Chacha20 and Poly1305 functions
i586-perl-Crypt-OpenSSL-AES - XS-wrapper around OpenSSL's AES library
i586-perl-Crypt-OpenSSL-Bignum - Perl module for OpenSSL's multiprecision integer arithmetic
i586-perl-Crypt-OpenSSL-DSA - Digital Signature Algorithm using OpenSSL
i586-perl-Crypt-OpenSSL-EC - Perl extension for OpenSSL EC (Elliptic Curves) library
i586-perl-Crypt-OpenSSL-ECDSA - Perl extension for OpenSSL ECDSA (Elliptic Curve Digital Signature Algorithm)
i586-perl-Crypt-OpenSSL-RSA - RSA encoding and decoding, using the openSSL libraries
i586-perl-Crypt-OpenSSL-Random - Routines for accessing the OpenSSL pseudo-random number generator
i586-perl-Crypt-OpenSSL-X509 - Perl interface to OpenSSL for X509
i586-perl-Crypt-RIPEMD160 - Perl extension for the RIPEMD-160 Hash function
i586-perl-Crypt-Rijndael - Crypt::CBC compliant Rijndael encryption module
i586-perl-Crypt-SSLeay - OpenSSL glue that provides LWP https support
i586-perl-Crypt-Twofish - The Twofish Encryption Algorithm
i586-perl-Crypt-UnixCrypt_XS - perl module Crypt-UnixCrypt_XS
i586-perl-CryptX - Crypto toolkit with multiple ciphers, hash functions and other
i586-perl-Curses - Terminal screen handling and optimization
i586-perl-Cyrus - Cyrus IMAP server utility Perl modules
i586-perl-DBD-InterBase - DBI driver for Firebird and InterBase RDBMS server
i586-perl-DBD-MariaDB - MariaDB driver for DBI interface in Perl
i586-perl-DBD-ODBC - Perl DBD module for interfacing with ODBC databases
i586-perl-DBD-Pg - PostgreSQL database driver for the DBI module
i586-perl-DBD-SQLite - SQLite driver for DBI interface in Perl
i586-perl-DBD-Sybase - Sybase database driver (TDS protocol) for the DBI module
i586-perl-DBD-mysql - MySQL driver for DBI interface in Perl
i586-perl-DBI - Database independent interface for Perl
i586-perl-DBM - Perl modules for accessing DBM databases
i586-perl-Data-Array2ArrayMap-Hash-XSTree - a Perl interface to multiple tree data structures.
i586-perl-Data-Array2ArrayMap-SDB - Perl && C++/XS module to access static db (SDB) files.
i586-perl-Data-BitStream-XS - A class implementing a stream of bits and coding methods
i586-perl-Data-Clone - Polymorphic data cloning
i586-perl-Data-Dump-Streamer - Accurately serialize a data structure as Perl code
i586-perl-Data-MessagePack - MessagePack serialising/deserialising
i586-perl-Data-Peek - Collection of low-level debug facilities
i586-perl-Data-Structure-Util - Change nature of data within a structure
i586-perl-Data-UUID - Perl extension for generating Globally/Universally Unique Identifiers (GUIDs/UUIDs)
i586-perl-Data-Util - A selection of utilities for data and data types
i586-perl-Date-Calc-XS - XS wrapper and C library plug-in for Date::Calc
i586-perl-Date-Pcalc - Gregorian calendar date calculations
i586-perl-Date-Simple - a simple date object
i586-perl-DateTime - DateTime base objects
i586-perl-Devel-CallChecker - custom op checking attached to subroutines
i586-perl-Devel-CallParser - custom parsing attached to subroutines
i586-perl-Devel-Caller - Meatier versions of caller()
i586-perl-Devel-Callsite - Get caller return OP address and Perl interpreter context
i586-perl-Devel-Cover - Code coverage metrics for Perl
i586-perl-Devel-DProf - A DEPRECATED Perl code profiler
i586-perl-Devel-Declare - Adding keywords to perl, in perl
i586-perl-Devel-FindRef - Where is that reference to my variable hiding?
i586-perl-Devel-Leak - Utility for looking for perl objects that are not reclaimed
i586-perl-Devel-LexAlias - Alias lexical variables
i586-perl-Devel-Mallinfo - Get mallinfo() malloc memory stats
i586-perl-Devel-NYTProf - Powerful fast feature-rich perl source code profiler
i586-perl-Devel-Refcount - Obtain the REFCNT value of a referent
i586-perl-Devel-Size - Perl extension for finding the memory usage of Perl variables
i586-perl-Device-SerialPort - Linux/POSIX emulation of Win32::SerialPort functions
i586-perl-Digest-BMW - Perl interface to the Blue Midnight Wish digest algorithm
i586-perl-Digest-CRC - Digest::CRC - Generic CRC functions
i586-perl-Digest-GOST - Perl interface to the GOST R 34.11-94 digest algorithm
i586-perl-Digest-Haval256 - A 5-round, 256-bit one-way hash function
i586-perl-Digest-JHash - Perl extension for 32 bit Jenkins Hashing Algorithm
i586-perl-Digest-MD2 - Perl interface to the MD2 Algorithm
i586-perl-Digest-MD4 - Perl interface to the MD4 Algorithm
i586-perl-Digest-SHA - Perl extension for SHA-1/224/256/384/512
i586-perl-Digest-SHA1 - Perl interface to the SHA1 algorithm
i586-perl-Digest-SHA3 - Perl extension for SHA-3
i586-perl-Digest-Whirlpool - A 512-bit, collision-resistant, one-way hash function
i586-perl-EV - Perl interface to libev, a high performance full-featured event loop
i586-perl-EV-ADNS - Perl module for lightweight asynchronous DNS queries using EV and libadns
i586-perl-Email-Address-XS - Parse and format RFC 2822 email addresses and groups
i586-perl-Enbugger - "Enables the debugger at runtime"
i586-perl-Encode - Character encodings
i586-perl-Encode-CN - China-based Chinese Encodings
i586-perl-Encode-Detect - Perl module that detects the encoding of data
i586-perl-Encode-EUCJPASCII - EucJP-ascii - An eucJP-open mapping
i586-perl-Encode-HanExtra - Extra sets of Chinese encodings
i586-perl-Encode-JIS2K - JIS X 0212 (aka JIS 2000) encodings
i586-perl-Encode-JP - Japanese Encodings
i586-perl-Encode-KR - Korean Encodings
i586-perl-Encode-TECkit - TECkit Encode interface
i586-perl-Encode-TW - Taiwan-based Chinese Encodings
i586-perl-Event - Event loop processing
i586-perl-Event-Lib - Perl extentions for event-based programming
i586-perl-FCGI - Fast CGI module for perl
i586-perl-File-FcntlLock - File locking with fcntl(2)
i586-perl-File-LibMagic - Perl wrapper for libmagic
i586-perl-File-Map - Memory mapping made simple and safe
i586-perl-File-Sync - Perl access to fsync() and sync() function calls
i586-perl-Filesys-Df - Perl extension for filesystem disk space information
i586-perl-Filesys-Statvfs - Perl extension for statvfs() and fstatvfs()
i586-perl-Filter - Source Filters
i586-perl-Function-Parameters - subroutine definitions with parameter lists
i586-perl-Fuse - Write filesystems in Perl using FUSE
i586-perl-GD - Perl interface to the GD graphics library
i586-perl-GSSAPI - Perl extension providing access to the GSSAPIv2 library
i586-perl-Geo-GDAL - Perl bindings for the GDAL library
i586-perl-Geo-IP - Look up country by IP Address
i586-perl-Glib - Perl module for the glib-2.x library
i586-perl-Glib-Object-Introspection - Dynamically create Perl language bindings
i586-perl-Gnome2 - Gnome2 Perl module
i586-perl-Gnome2-Canvas - Gnome2-Canvas Perl module
i586-perl-Gnome2-GConf - Perl wrappers for the GConf configuration engine
i586-perl-Gnome2-VFS - Gnome2-VFS Perl module
i586-perl-Gnome2-Wnck - Perl interface to the Window Navigator Construction Kit
i586-perl-Goo-Canvas - Perl interface to the GooCanvas
i586-perl-GooCanvas2-CairoTypes - Bridge between GooCanvas2 and Cairo types
i586-perl-Graph-Layout-Aesthetic - A module for laying out graphs
i586-perl-Graphics-TIFF - Perl extension for the libtiff library
i586-perl-GraphicsMagick - Libraries and modules for access to GraphicsMagick from perl
i586-perl-Gtk2 - Perl bindings to the gtk+-2.x library
i586-perl-Gtk2-GladeXML - Create user interfaces directly from Glade XML files
i586-perl-Gtk2-ImageView - Perl bindings for the GtkImageView widget
i586-perl-Gtk2-Sexy - Perl interface to the sexy widget collection
i586-perl-Gtk2-Spell - Perl bindings for GtkSpell with Gtk2
i586-perl-Gtk2-TrayIcon - Gtk2-TrayIcon Perl module
i586-perl-Gtk2-Unique - Use single instance applications
i586-perl-Guard - Safe cleanup blocks for Perl
i586-perl-HTML-Escape - Extremely fast HTML escape
i586-perl-HTML-Parser - Parsing and extracting information from HTML documents
i586-perl-HTML-Template-Pro - Perl+C/XS module to produce HTML from HTML Template files.
i586-perl-HTML-Tidy - HTML validation in a Perl object
i586-perl-HTTP-Parser-XS - A fast, primitive HTTP request parser
i586-perl-Hash-FieldHash - Lightweight field hash implementation
i586-perl-IO-AIO - Asynchronous Input/Output
i586-perl-IO-Epoll - Scalable IO Multiplexing for Linux
i586-perl-IO-FDPass - pass a file descriptor over a socket
i586-perl-IO-Interface - extention for IO::Socket
i586-perl-IO-Socket-Multicast - Send and receive multicast messages
i586-perl-IO-Tty - interface to pseudo tty's
i586-perl-IPC-Mmap - Minimal unified mmap for POSIX and Win32
i586-perl-IPC-ShareLite - Light-weight interface to shared memory
i586-perl-Image-PNG-Libpng - Perl interface to libpng
i586-perl-Image-Sane - Perl extension for the SANE (Scanner Access Now Easy) Project
i586-perl-Imager - Perl module for generating 24 bit Images
i586-perl-Inline-Python - Write Perl subs and classes in Python
i586-perl-JSON-DWIW - Flexible and fast JSON converter for Perl
i586-perl-JSON-Parse - Read JSON into a Perl variable
i586-perl-JSON-XS - JSON serialising/deserialising, done correctly and fast
i586-perl-JSON-XS3 - JSON serialising/deserialising, done correctly and fast
i586-perl-JavaScript-Minifier-XS - XS based JavaScript minifier
i586-perl-JavaScript-V8 - JavaScript::V8 - Perl interface to the V8 JavaScript engine
i586-perl-KyotoCabinet - a straightforward implementation of DBM
i586-perl-Lchown - Perl interface to the lchown(2) system call
i586-perl-Lexical-SealRequireHints - Prevent leakage of lexical hints
i586-perl-Lexical-Var - Static variables without name space pollution
i586-perl-Linux-Inotify2 - Scalable directory/file change notification
i586-perl-Linux-Personality - Perl interface to the personality(2) Linux system call
i586-perl-Linux-Pid - Get the native PID and the PPID on Linux
i586-perl-List-MoreUtils-XS - Provide compiled List::MoreUtils functions
i586-perl-Locale-Hebrew - Bidirectional Hebrew support
i586-perl-Locale-gettext - Gettext routines for Perl
i586-perl-LockDev - Perl interface for the lockdev library
i586-perl-MIME-Explode - Perl extension for explode MIME messages
i586-perl-MRO-Define - Define your own method resolution order
i586-perl-Magick - Libraries and modules for access to ImageMagick from perl
i586-perl-Mail-Transport-Dbx - Parse Outlook Express mailboxes
i586-perl-Marpa-R2 - Release 2 of Marpa
i586-perl-Math-BigInt-FastCalc - XS implementation of arbitrary size integer math
i586-perl-Math-BigInt-GMP - Use the GMP library for Math::BigInt routines
i586-perl-Math-BigInteger - Math::BigInteger - arbitrary length integer extension module for Perl
i586-perl-Math-Decimal64 - (alpha) perl interface to C's _Decimal64 operations.
i586-perl-Math-FFT - Perl extension for Fast Fourier Transforms
i586-perl-Math-Factor-XS - Factorize numbers and calculate matching multiplications
i586-perl-Math-GMP - High speed arbitrary size integer math
i586-perl-Math-GMPf - perl interface to the GMP library's floating point (mpf) functions..
i586-perl-Math-GMPn - Fixed length integer arithmetic.
i586-perl-Math-GMPq - perl interface to the GMP library's rational (mpq) functions..
i586-perl-Math-GMPz - perl interface to the GMP library's integer (mpz) functions..
i586-perl-Math-Geometry-Voronoi - Compute Voronoi diagrams from sets of points
i586-perl-Math-Int64 - Perl module to manipulate 64 bits integers
i586-perl-Math-Libm - Perl extension for the C math library, libm
i586-perl-Math-LongDouble - perl module Math-LongDouble
i586-perl-Math-MPFR - perl interface to the MPFR (floating point) library..
i586-perl-Math-Pari - Perl interface to PARI
i586-perl-Math-Prime-Util - Utilities related to prime numbers, including fast sieves and factoring
i586-perl-Math-Prime-Util-GMP - Utilities related to prime numbers, using GMP
i586-perl-Math-Prime-XS - Detect and calculate prime numbers with deterministic tests
i586-perl-Math-Random-ISAAC-XS - C implementation of the ISAAC PRNG algorithm
i586-perl-Mcrypt - Mcrypt - Perl extension for the Mcrypt cryptography library
i586-perl-Moose - A postmodern object system for Perl 5
i586-perl-MooseX-Role-WithOverloading - Roles which support overloading
i586-perl-Mouse - Moose minus the antlers
i586-perl-Mozilla-LDAP - LDAP Perl module that wraps the Mozilla C SDK
i586-perl-Net-ARP - Perl extension for creating ARP packets
i586-perl-Net-CUPS - Perl interface to the Common Unix Printing System API
i586-perl-Net-DBus - Perl extension for the DBus message system
i586-perl-Net-DNS-SEC - Net-DNS-SEC module for perl
i586-perl-Net-DNS-ToolKit - Tools for working with DNS packets
i586-perl-Net-IDN-Encode - Encoding and decoding of Internationalized Domain Names
i586-perl-Net-LibAsyncNS - a Perl wrapper around F<libasyncns>
i586-perl-Net-LibIDN - Perl bindings for GNU LibIDN
i586-perl-Net-Libdnet - Binding for Dug Song's libdnet
i586-perl-Net-Patricia - Patricia Trie perl module for fast IP address lookups
i586-perl-Net-Pcap - Interface to pcap(3) LBL packet capture library
i586-perl-Net-RawIP - Perl extension to manipulate raw IP packets
i586-perl-Net-SSH-Perl - Perl client interface to SSH
i586-perl-Net-SSH2 - Support for the SSH 2 protocol via libssh2
i586-perl-Net-SSLeay - Perl extension for using OpenSSL
i586-perl-NetAddr-IP - Manages IP addresses and subnets
i586-perl-Newt - Perl bindings for the Newt library
i586-perl-OSSP-uuid - perl bindings for Universally Unique Identifier library
i586-perl-OpenGL - Perl bindings to OpenGL API
i586-perl-PCP-LogImport - Performance Co-Pilot (PCP) Perl bindings for importing external data into PCP archives
i586-perl-PCP-MMV - Performance Co-Pilot (PCP) Perl bindings for PCP Memory Mapped Values
i586-perl-PCP-PMDA - Performance Co-Pilot (PCP) Perl bindings and documentation
i586-perl-PDL - The Perl Data Language
i586-perl-POSIX-1003 - POSIX::1003, alternative for POSIX in core
i586-perl-POSIX-Regex - OO interface for the gnu regex engine
i586-perl-POSIX-strptime - Perl extension to the POSIX date parsing strptime(3) function
i586-perl-PPI-XS - Perl module with XS acceleration for PPI
i586-perl-PPerl - Make perl scripts persistent in memory
i586-perl-Package-Stash-XS - Faster and more correct implementation of the Package::Stash API
i586-perl-PadWalker - Inspect lexical variables in any subroutine which called you
i586-perl-Pango - Layout and render international text
i586-perl-Params-Classify - Argument type classification
i586-perl-Params-Util - Simple standalone param-checking functions
i586-perl-Params-Validate - Validate method/function parameters
i586-perl-Parse-ExuberantCTags - Efficiently parse exuberant ctags files
i586-perl-Passwd-Linux - Perl module for manipulating the passwd and shadow files
i586-perl-Perl-Destruct-Level - Allows you to change perl's internal destruction level
i586-perl-PerlIO-Layers - Querying your file handle capabilities
i586-perl-PerlIO-Util - A selection of general PerlIO utilities
i586-perl-PerlIO-eol - PerlIO layer for normalizing line endings
i586-perl-PerlIO-gzip - A layer for the PerlIO system to transparently gzip/gunzip files
i586-perl-PerlIO-utf8_strict - fast and correct UTF-8 IO module
i586-perl-PerlX-Maybe-XS - XS backend for PerlX::Maybe
i586-perl-Pg - PostgreSQL database native Perl driver
i586-perl-Pg-PQ - Perl wrapper for PostgreSQL libpq
i586-perl-Prima - Perl graphic toolkit
i586-perl-Proc-FastSpawn - fork+exec, or spawn, a subprocess as quickly as possible
i586-perl-Proc-ProcessTable - Perl extension to access the unix process table
i586-perl-Proc-Wait3 - Perl wrapper around the wait3(1) system call
i586-perl-Quota - Perl interface to file system quotas
i586-perl-RPM - Native bindings to the RPM Package Manager API
i586-perl-RPM2 - Perl bindings for the RPM Package Manager API
i586-perl-RRD - Round Robin Database perl modules
i586-perl-Razor - Perl modules for Razor
i586-perl-Readonly-XS - Companion module for perl-Readonly
i586-perl-Ref-Util-XS - XS implementation for Ref::Util Perl module
i586-perl-SDL - Simple DirectMedia Layer for Perl
i586-perl-SGML-Parser-OpenSP - Parse SGML documents using OpenSP
i586-perl-SNMP - Perl SNMP Extension Module
i586-perl-Sane - Perl extension for the SANE (Scanner Access Now Easy) Project
i586-perl-Scalar-String - string aspects of scalars
i586-perl-Scalar-Util-Instance - Generates and installs is-a predicates
i586-perl-Scope-Upper - Act on upper scopes
i586-perl-Search-Xapian - Xapian perl bindings
i586-perl-Sereal-Decoder - Fast, compact, powerful binary deserialization
i586-perl-Sereal-Encoder - Fast, compact, powerful binary serialization
i586-perl-Set-Object - Unordered collections (sets) of Perl Objects
i586-perl-Socket-MsgHdr - Sendmsg, recvmsg and ancillary data operations
i586-perl-Socket-Netlink - interface to Linux's PF_NETLINK socket family
i586-perl-Socket6 - Socket6 Perl module
i586-perl-Sort-Key - Fastest way to sort anything in Perl
i586-perl-Statistics-CaseResampling - Perl module for resampling and calculation of medians with confidence intervals
i586-perl-String-Approx - Perl extension for approximate matching (fuzzy matching)
i586-perl-String-CRC - Cyclic redundency check generation
i586-perl-String-CRC32 - Cyclic redundency check generation
i586-perl-String-Compare-ConstantTime - Timing side-channel protected string compare
i586-perl-String-Similarity - Calculates the similarity of two strings
i586-perl-Sub-Attribute - Reliable subroutine attribute handlers
i586-perl-Sub-Current - Perl module to get the current subroutine
i586-perl-Sub-Identify - Retrieve names of code references
i586-perl-Sub-Name - (re)name a sub
i586-perl-Sys-CPU - Getting CPU information
i586-perl-Sys-CPUtime - Perl extension for SIGXCPU workaround
i586-perl-Sys-Guestfs - Perl bindings for libguestfs (Sys::Guestfs)
i586-perl-Sys-Hostname-FQDN - Get the short or long hostname
i586-perl-Sys-MemInfo - Memory information as Perl module
i586-perl-Sys-Mmap - Perl module to use mmap to map in a file as a Perl variable
i586-perl-Sys-Virt - Represent and manage a libvirt hypervisor connection
i586-perl-Template - Perl Template Toolkit
i586-perl-Term-ReadLine-Gnu - Perl interface to the GNU Readline library
i586-perl-Term-Size - Perl module for get the size of the terminal
i586-perl-TermReadKey - simple control over terminal driver modes
i586-perl-Test-LeakTrace - Trace memory leaks
i586-perl-Test-Taint - Checks for taintedness of variables
i586-perl-Text-Aspell - Perl interface to the GNU Aspell library
i586-perl-Text-BibTeX - Interface to read and parse BibTeX files
i586-perl-Text-Bidi - Unicode bidi algorithm for Perl using libfribidi
i586-perl-Text-CHM - Perl module for handling Compiled HtmlHelp Files (.chm)
i586-perl-Text-CSV_XS - Comma-separated values manipulation routines
i586-perl-Text-CharWidth - Get number of occupied columns of a string on terminal
i586-perl-Text-ExtractWords - Perl extension for extract words from strings
i586-perl-Text-Iconv - Perl interface to iconv(3) codeset conversion function
i586-perl-Text-Kakasi - Perl frontend to kakasi
i586-perl-Text-Markdown-Hoedown - hoedown for Perl5
i586-perl-Text-Ngram - Ngram analysis of text
i586-perl-Text-Soundex - Implementation of the Soundex algorithm as described by Knuth
i586-perl-Text-Xslate - Text::Xslate - Scalable template engine for Perl5
i586-perl-Thread-SigMask - Thread specific signal masks
i586-perl-Tie-CArray - space-efficient, typed, external C Arrays
i586-perl-Time-Format_XS - Companion module for Time::Format, to speed up time formatting
i586-perl-Time-Moment - Represents a date and time of day with an offset from UTC
i586-perl-Time-Piece - Object Oriented time objects
i586-perl-Time-TZOffset - Show timezone offset strings like +0900
i586-perl-Time-Warp - Control over the flow of time
i586-perl-Tk - Perl modules providing the Tk graphics library
i586-perl-Tk-TableMatrix - The Tk::TableMatrix Widget
i586-perl-TokyoCabinet - TokyoCabinet - Perl module
i586-perl-URI-Escape-XS - Drop-In replacement for URI::Escape
i586-perl-URI-UTF8-Punycode - Punycode conversion of UTF-8 string.
i586-perl-URL-Encode-XS - XS implementation of URL::Encode
i586-perl-UUID - DCE compatible Universally Unique Identifier library for Perl
i586-perl-Unicode-CaseFold - Unicode case-folding for case-insensitive lookups.
i586-perl-Unicode-CheckUTF8 - Checks if scalar is valid UTF-8
i586-perl-Unicode-Collate - Unicode Collation Algorithm
i586-perl-Unicode-LineBreak - UAX #14 Unicode Line Breaking Algorithm
i586-perl-Unicode-Map - Maps charsets from and to utf16 unicode
i586-perl-Unicode-Map8 - Perl module to represent mapping tables between 8-bit chars and Unicode
i586-perl-Unicode-Normalize - Unicode normalization forms
i586-perl-Unicode-String - Perl module to represent strings of Unicode chars
i586-perl-Unicode-UTF8 - Encoding and decoding of UTF-8 encoding form
i586-perl-Unix-Mknod - Perl extension for mknod, major, minor, and makedev
i586-perl-Unix-Syslog - Perl interface to the UNIX system logger
i586-perl-Variable-Magic - Associate user-defined magic to variables from Perl
i586-perl-WWW-Curl - Perl extension interface for libcurl
i586-perl-WWW-Form-UrlEncoded-XS - XS implementation of parser and builder for application/x-www-form-urlencoded
i586-perl-Want - A generalisation of "wantarray"
i586-perl-Wx - wxPerl - Perl bindings for wxWindows
i586-perl-Wx-GLCanvas - Interface to wxWidgets' OpenGL canvas
i586-perl-Wx-Scintilla - Wx::Scintilla - Scintilla source code editing component for wxWidgets
i586-perl-X-Osd - Perl extension to the X On Screen Display library (xosd)
i586-perl-X11-GUITest - Collection of functions for X11 GUI testing/interaction
i586-perl-X11-Xlib - Low-level access to the X11 library
i586-perl-XML-Bare - A minimal XML parser / schema checker / pretty-printer using C internally
i586-perl-XML-LibXML - Perl binding for libxml2
i586-perl-XML-LibXSLT - Perl interface to the Gnome libxslt library
i586-perl-XML-Parser - Perl module for parsing XML files
i586-perl-XML-SAX-ExpatXS - Perl SAX 2 XS extension to Expat parser
i586-perl-YAML-LibYAML - Perl YAML Serialization using XS and libyaml
i586-perl-YAML-LibYAML-API - Wrapper around the C libyaml library
i586-perl-YAML-Syck - Fast, lightweight YAML loader and dumper
i586-perl-autobox - Perl interface to call methods on native types
i586-perl-autovivification - Lexically disable autovivification
i586-perl-base - Pathologically Eclectic Rubbish Lister
i586-perl-constant-lexical - Perl pragma to declare lexical compile-time constants
i586-perl-devel - Perl header files and development modules
i586-perl-forks - Drop-in replacement for Perl threads using fork()
i586-perl-highlight - perl bindings for highlight source code to formatted text converter
i586-perl-hivex - Perl bindings for hivex
i586-perl-libapreq2 - Perl interface to the Apache HTTP request library
i586-perl-libintl - High-Level Interface to Uniforum Message Translation
i586-perl-obexftp - Perl bindings for obexftp
i586-perl-pcsc - Perl interface to the PC/SC smart card library
i586-perl-prelude - Perl bindings for prelude
i586-perl-qa-cache - Simple and efficient cache for memoization
i586-perl-qa-rpmelfsym - Faster rpmelfsym(1) and bad_elf_symbols implementation
i586-perl-stfl - Perl binding to stfl
i586-perl-threads - Perl thread modules
perl-GraphicsMagick-demo - Demo for GraphicsMagick perl binding
alterator-perl-functions - helper functions for alterator perl based backends
perl-ALTLinux-RepoList - ALTLinux-RepoList - Perl extension for quering ALTLinux repository list files
apache2-mod_perl-doc - mod_perl2 Apache module documentation
perl-Collectd - Perl module for collectd
perl-RPM-Specfile-Multispec - RPM::Specfile::Multispec - Perl extension for creating RPM Specfiles
perl-Dpkg - Package maintenance system for Debian Linux
perl-Git - Perl interface to Git
perl-NTP-Util - Perl NTP module
perl-PCP-LogSummary - Performance Co-Pilot (PCP) Perl bindings for post-processing output of pmlogsummary
perl-pod - Perl documentation
perl-unicore - Perl Unicode library
perl-ALTLinux-ACL - ALTLinux-ACL - Perl extension for quering ALTLinux ACL files
perl-ALTLinux-Girar-UploadMethod - ALTLinux-Girar-UploadMethod - Perl extension for quering ALTLinux ACL files
perl-AWS-Signature4 - create a version4 signature for Amazon Web Services
perl-Affix-Infix2Postfix - Perl module for converting from infix notation to postfix notation
perl-Algorithm-Annotate - Represent a series of changes in annotation list
perl-Algorithm-C3 - Algorithm::C3 - A module for merging hierarchies using the C3 algorithm
perl-Algorithm-CheckDigits - Perl extension to generate and test check digits
perl-Algorithm-CheckDigits-scripts - perl-Algorithm-CheckDigits scripts
perl-Algorithm-Dependency - Algorithm-Dependency - Create extensible and optimized dependency algorithms
perl-Algorithm-Diff - Compute `intelligent' differences between two files / lists
perl-Algorithm-Merge - Three-way merge and diff
perl-Algorithm-NaiveBayes - Bayesian prediction of categories
perl-Alien-Base-ModuleBuild - Perl framework for building Alien:: modules and their libraries
perl-Alien-Build - Build external dependencies for use in CPAN
perl-Alien-Role-Alt - Alien::Base role that supports alternates
perl-Alien-SDL - Building, finding and using SDL binaries
perl-Alien-SDL-scripts - perl-Alien-SDL scripts
perl-Alien-SeleniumRC - Packaging up SeleniumRC java server
perl-Alterator-Automate - Control host via web alterator from perl code
perl-Amazon-S3 - A portable client library for working with and
perl-Amazon-SQS-Simple - OO API for accessing the Amazon Simple Queue
perl-Amazon-SimpleDB - a low-level perlish interface for
perl-Amon2 - Amon2 - lightweight web application framework
perl-Amon2-Lite - Amon2::Lite - Sinatra-ish framework on Amon2
perl-Any-Moose - Use Moose or Mouse automagically
perl-AnyData - Easy access to data in many formats
perl-AnyEvent - Framework for multiple event loops
perl-AnyEvent-AIO - asynchronous file and directory I/O
perl-AnyEvent-BDB - asynchronous berkeley db access
perl-AnyEvent-CacheDNS - Simple DNS resolver with caching
perl-AnyEvent-Fork - everything you wanted to use fork() for, but couldn't
perl-AnyEvent-Gearman - AnyEvent::Gearman - Asynchronous Gearman client/worker module for AnyEvent applications
perl-AnyEvent-Graphite - Perl non-blocking Graphite client
perl-AnyEvent-HTTP - AnyEvent::HTTP - simple but non-blocking HTTP/HTTPS client
perl-AnyEvent-HTTP-LWP-UserAgent - Perl module AnyEvent::HTTP::LWP::UserAgent
perl-AnyEvent-I3 - Communicate with the i3 window manager
perl-AnyEvent-RabbitMQ - An asynchronous and multi channel Perl AMQP client.
perl-AnyEvent-SNMP - Perl adaptor to integrate Net::SNMP into AnyEvent
perl-AnyEvent-Twitter-Stream - Receive Twitter streaming API in an event loop
perl-Apache-AuthCookie-Util - Perl Authentication and Authorization via cookies
perl-Apache2-AuthCookie - Perl Authentication and Authorization via cookies
perl-Apache-DBI - Persistent database connections for mod_perl
perl-Apache-Htpasswd - This module comes with a set of methods to use with htaccess password files.
perl-Apache-LogFormat-Compiler - Compile a log format string to perl-code
perl-Apache-Session - A persistence framework for session data
perl-Apache2-SOAP - A replacement for Apache::SOAP designed to work with mod_perl 2
perl-App-Asciio - Plain ASCII diagram
perl-App-CLI - Dispatcher module for command line interface programs
perl-App-Cache - Easy application-level caching
perl-App-Cmd - Perl module to write CLI apps with less suffering
perl-App-Control - Perl module for apachectl style control of another script or
perl-App-Daemon - Start an Application as a Daemon
perl-App-Nopaste - Easy access to any pastebin
perl-App-Rad - Extend the App::Rad framework!
perl-App-cpanminus - App::cpanminus - get, unpack, build and install modules from CPAN
perl-App-perlbrew - Manage perl installations in your $HOME
perl-App-s2p - a stream editor
perl-AppConfig - Perl module for reading configuration files
perl-AppConfig-Std - Subclass of AppConfig that provides standard options
perl-Arch - GNU Arch Perl library
perl-Archive-Any - Single interface to deal with file archives.
perl-Archive-Any-Lite - Simple CPAN package extractor
perl-Archive-Extract - A generic archive extracting mechanism
perl-Archive-Tar - Module for creation and manipulation of tar archives
perl-Archive-Tar-Wrapper - Perl wrapper around the 'tar' utility
perl-Archive-Zip - Perl module for manipulating Zip archives
perl-Archive-Zip-scripts - perl-Archive-Zip scripts
perl-Array-Columnize - Arrange list data in columns
perl-Array-Compare - Array::Compare - perl module comparing arrays
perl-Array-Diff - Find the differences between two arrays
perl-Array-Iterator - A subclass of Array::Iterator to allow forwards and backwards iteration
perl-Array-Unique - Array::Unique - Tie-able array that allows only unique values
perl-Asterisk-AMI - Perl module for interacting with the Asterisk Manager Interface
perl-Asterisk-FastAGI - Asterisk-FastAGI - Perl module
perl-Asterisk-config - The Asterisk config read and write module
perl-Astro-SunTime - Astro::SunTime provides a function interface to calculate sun rise/set times.
perl-Attribute-Handlers - Simpler definition of attribute handlers
perl-Audio-MPD - Class to talk to MPD (Music Player Daemon) servers
perl-Audio-MPD-Common - Common helper classes for mpd
perl-Authen-DigestMD5 - SASL DIGEST-MD5 authentication (RFC2831)
perl-Authen-ModAuthPubTkt - Generate Tickets (Signed HTTP Cookies) for mod_auth_pubtkt protected websites
perl-Authen-Passphrase - hashed passwords/passphrases as objects
perl-Authen-Radius - provide simple Radius client facilities
perl-Authen-SASL - SASL authentication framework for Perl
perl-Authen-SASL-SASLprep - A Stringprep Profile for User Names and Passwords (RFC 4013)
perl-Authen-SCRAM - Salted Challenge Response Authentication Mechanism (RFC 5802)
perl-Authen-Simple - Simple Authentication
perl-Authen-Simple-Passwd - Simple Passwd authentication
perl-AutoXS-Header - Container for the AutoXS header files
perl-B-Debug - B::Debug - Walk Perl syntax tree, printing debug info about ops
perl-B-Deobfuscate - deobfuscate Perl source code
perl-B-Graph - Perl compiler backend to produce graphs of OP trees
perl-B-Hooks-EndOfScope - Execute code after a scope finished compilation
perl-B-Keywords - Perl module with lists of reserved barewords and symbol names
perl-B-Lint - Perl lint
perl-BFD - dump of data structures for debugging purposes
perl-BIND-Config-Parser - Parse BIND Config file
perl-BSON - Pure Perl implementation of MongoDB's BSON serialization
perl-Barcode-Code128 - Generate CODE 128 bar codes
perl-Benchmark-Timer - Benchmarking with statistical confidence
perl-BenchmarkAnything-Config - Read BenchmarkAnything configfile
perl-BenchmarkAnything-Reporter - Handle result reporting to a BenchmarkAnything HTTP/REST API
perl-Best - Best - Fallbackable module loader
perl-BibTeX-Parser - A pure perl BibTeX parser
perl-Biblio-EndnoteStyle - reference formatting using Endnote-like templates
perl-Bloom-Filter - Sample Perl Bloom filter implementation
perl-Boulder - An API for hierarchical tag/value structures
perl-Browser-Open - Open a browser in a given URL
perl-Business-Hours - Calculate business hours in a time period
perl-Business-ISBN - work with International Standard Book Numbers
perl-Business-ISBN-Data - data pack for Business::ISBN
perl-Business-ISMN - Work with International Standard Music Numbers
perl-Business-ISSN - Work with International Standard Serial Numbers
perl-Bytes-Random-Secure - Perl extension to generate cryptographically-secure random bytes.
perl-CACertOrg-CA - CACert.org's CA root certificate in PEM format
perl-CDDB_get - This module/script gets the CDDB info for an audio cd
perl-CGI - Simple CGI class for Perl
perl-CGI-Ajax - CGI::Ajax - a perl-specific system for writing Asynchronous web applications
perl-CGI-Apache - CGI::Apache - Backward compatibility module for CGI.pm
perl-CGI-Application - Framework for building reusable web-applications
perl-CGI-Compile - CGI::Compile - Compile .cgi scripts to a code reference like ModPerl::Registry
perl-CGI-Emulate-PSGI - CGI::Emulate::PSGI - PSGI adapter for CGI
perl-CGI-Ex - CGI utility suite
perl-CGI-Ex-samples - sample files for CGI::Ex
perl-CGI-Expand - converts a CGI query into structured data
perl-CGI-Fast - CGI::Fast is a subclass of the CGI object created by CGI.pm
perl-CGI-FastTemplate - Perl extension for managing templates, and performing variable interpolation
perl-CGI-FormBuilder - Perl module for easily generation and processing stateful forms
perl-CGI-Lite - Process and decode WWW forms and cookies
perl-CGI-PSGI - Enable your CGI.pm aware applications to adapt PSGI protocol
perl-CGI-SSI - Perl module for using SSI from CGI scripts
perl-CGI-Session - Persistent session data in CGI applications
perl-CGI-Session-SQLite - Simple Common Gateway Interface class for Perl
perl-CGI-Simple - A Simple totally OO CGI interface that is CGI.pm compliant
perl-CGI-Struct - Build structures from CGI data
perl-CHI - CHI - Unified cache handling interface
perl-CLASS - Alias for __PACKAGE__
perl-CLI-Osprey - MooX::Options + MooX::Cmd + Sanity
perl-CPAN - Download and build Perl modules from CPAN sites
perl-CPAN-Changes - Read and write Changes files
perl-CPAN-Checksums - CPAN::Checksums - Write a "CHECKSUMS" file for a directory as on CPAN
perl-CPAN-Common-Index - Common library for searching CPAN modules, authors and distributions
perl-CPAN-DistnameInfo - Extract distribution name and version from a distribution filename
perl-CPAN-Inject - CPAN::Inject - Base class for injecting distributions into CPAN sources
perl-CPAN-Meta - The distribution metadata for a CPAN dist
perl-Parse-CPAN-Meta - Parse::CPAN::Meta - Parse META.yml and META.json CPAN metadata files
perl-CPAN-Meta-Check - Verify requirements in a CPAN::Meta object
perl-CPAN-Meta-Requirements - a set of version requirements for a CPAN dist
perl-CPAN-Meta-YAML - Read and write a subset of YAML for CPAN Meta files
perl-CPAN-Perl-Releases - Mapping Perl releases on CPAN to the location of the tarballs
perl-CPAN-Reporter - Adds CPAN Testers reporting to CPAN.pm
perl-CPAN-Uploader - Perl module to upload things to the CPAN
perl-CQL-Parser - Common Query Language Parser
perl-CSS - Object oriented access to Cascading Style Sheets (CSS)
perl-CSS-Compressor - Perl extension for CSS minification
perl-CSS-Minifier - Remove unnecessary whitespace from CSS files
perl-CSS-Squish - Compact many CSS files into one big file
perl-CSS-Tiny - Read/Write .css files with as little code as possible
perl-Cache - Cache - the Cache interface
perl-Cache-Cache - Cache-Cache - - the Cache interface
perl-Cache-Memcached - an object-oriented Perl module for memcached
perl-Cache-Ref - Memory only cache of live references
perl-Cache-Simple-TimedExpiry - Cache-Simple-TimedExpiry - A lightweight cache with timed expiration
perl-Calendar-Simple - Calendar-Simple - Perl module
perl-Canary-Stability - canary to check perl compatibility for schmorp's modules
perl-Captcha-reCAPTCHA-V3 - A Perl implementation of reCAPTCHA API version v3
perl-Captcha-reCaptcha - A Perl implementation of the reCAPTCHA API
perl-Capture-Tiny - Capture::Tiny - Capture STDOUT and STDERR from Perl, XS or external programs
perl-Carp-Always - Warn and die in Perl noisily with stack backtraces
perl-Carp-Assert - Carp-Assert - executable comments
perl-Carp-Assert-More - Carp-Assert-More - convenience wrappers around Carp::Assert
perl-Carp-Clan - Report errors from perspective of caller of a "clan" of modules
perl-Carp-Datum - Carp-Datum module for perl
perl-Catalyst-Action-RenderView - Catalyst::Action::RenderView - Sensible default end action
perl-Catalyst-Component-InstancePerContext - Moose role to create only one instance of component per context
perl-Catalyst-Controller-HTML-FormFu - HTML::FormFu controller for Catalyst
perl-Catalyst-Devel - Catalyst Development Tools
perl-Catalyst-DispatchType-Regex - Regex DispatchType
perl-Catalyst-Manual - The Catalyst developer's manual
perl-Catalyst-Model-DBIC-Schema - DBIx::Class::Schema Model Class
perl-Catalyst-Plugin-Authentication - Infrastructure plugin for the Catalyst
perl-Catalyst-Plugin-Authorization-Roles - Catalyst::Plugin::Authorization::Roles - Role based authorization for Catalyst
perl-Catalyst-Plugin-CRUD - CRUD (create/read/update/delete) Plugin for Catalyst
perl-Catalyst-Plugin-ConfigLoader - Catalyst::Plugin::ConfigLoader - Load config files of various types
perl-Catalyst-Plugin-FormValidator - Catalyst::Plugin::FormValidator - FormValidator for Catalyst
perl-Catalyst-Plugin-HTML-Widget - HTML Widget Catalyst Plugin
perl-Catalyst-Plugin-Redirect - Redirect for Catalyst used easily is offered
perl-Catalyst-Plugin-Session - Catalyst::Plugin::Session - Generic Session plugin - ties together server side
perl-Catalyst-Plugin-Session-State-Cookie - Catalyst::Plugin::Session::State::Cookie - Maintain session IDs using cookies
perl-Catalyst-Plugin-Session-Store-FastMmap - FastMmap session storage backend
perl-Catalyst-Plugin-Session-Store-File - File storage backend for session data
perl-Catalyst-Plugin-Static-Simple - Catalyst::Plugin::Static::Simple - Make serving static pages painless
perl-Catalyst-Runtime - Catalyst Framework Runtime
perl-Catalyst-Runtime-scripts - Scripts for perl-Catalyst-Runtime
perl-Catalyst-View-HTML-Mason - Helper for L<Catalyst::View::HTML::Mason> views
perl-Catalyst-View-Mason - Mason View Class
perl-Catalyst-View-TT - Catalyst::View::TT - Template View Class
perl-Catalyst-View-TT-Alloy - Template::Alloy (TT) View Class
perl-CatalystX-Component-Traits - Automatic Trait Loading and Resolution for Catalyst Components
perl-Chart - A series of charting modules
perl-Check-ISA - Check::ISA perl module
perl-Class-Accessor - Automated accessor generation
perl-Class-Accessor-Chained - Class::Accessor::Chained - make chained accessors
perl-Class-Accessor-Class - simple class variable accessors
perl-Class-Accessor-Grouped - Lets you build groups of accessors
perl-Class-Accessor-Lite - Class::Accessor::Lite - a minimalistic variant of Class::Accessor
perl-Class-Adapter - Class::Adapter - Perl implementation of the "Adapter" Design Pattern
perl-Class-Autouse - Class-Autouse - Run-time class loading on first method call
perl-Class-Base - Class::Base - useful base class for deriving other modules
perl-Class-C3 - A pragma to use the C3 method resolution order algortihm
perl-Class-C3-Adopt-NEXT - Make NEXT suck less
perl-Class-C3-Componentised - Load mix-ins or components to your C3-based class.
perl-Class-CGI - Class::CGI - fetch objects from your CGI object
perl-Class-Container - Glues object frameworks together transparently
perl-Class-DBI - Simple Database Abstraction
perl-Class-DBI-BaseDSN - DSN sensitive base class
perl-Class-DBI-Pg - Class::DBI extension for PostgreSQL
perl-Class-DBI-SQLite - Extension to Class::DBI for SQLite
perl-Class-Data-Accessor - Class::Data::Accessor - Inheritable, overridable class and instance data accessor creation
perl-Class-Data-Inheritable - Inheritable, overridable class data
perl-Class-Date - Class for easy date and time manipulation
perl-Class-EHierarchy - Base class for hierarchally ordered objects
perl-Class-ErrorHandler - Base class for error handling
perl-Class-Exporter - Export class methods as regular subroutines
perl-Class-Factory-Util - Class-Factory-Util - Perl module
perl-Class-Field - Class Field Accessor Generator
perl-Class-Fields - Inspect the fields of a class
perl-Class-Forward - A class dispatcher that handles namespaces like paths
perl-Class-Gomor - another class and object builder
perl-Class-ISA - report the search path for a class's ISA tree
perl-Class-InsideOut - Class::InsideOut - safe, simple inside-out object construction kit
perl-Class-Inspector - Get information about a class and its structure
perl-Class-Iterator - Class::Iterator - generic iterator object class
perl-Class-Load - A working (require "Class::Name") and more
perl-Class-Loader - Load modules and create objects on demand
perl-Class-MakeMethods - Generate common types of methods
perl-Class-Measure - Create, compare, and convert units of measurement.
perl-Class-Member - A set of modules to make the module developement easier
perl-Class-Method-Modifiers - provides Moose-like method modifiers
perl-Class-Mix - Dynamic class mixing
perl-Class-Refresh - refresh your classes during runtime
perl-Class-ReturnValue - Class-ReturnValue - A smart return value object
perl-Class-Singleton - Implementation of a "Singleton" class
perl-Class-StateMachine - Define classes for state machines
perl-Class-Std - Perl module for creating standard "inside-out" classes
perl-Class-Std-Fast - Perl module that provides a faster but less secure version of Class::Std
perl-Class-Throwable - A minimal lightweight exception class
perl-Class-Tiny - Minimalist class construction
perl-Class-Trigger - Mixin to add / call inheritable triggers
perl-Class-Unload - Unload a class
perl-Class-Virtual - perl module Class-Virtual
perl-Class-WhiteHole - Base class to treat unhandled method calls as errors
perl-Clipboard - Cliboard - Copy and Paste with any OS
perl-Clipboard-scripts - perl-Clipboard scripts
perl-Clone-Choose - Choose appropriate clone utility
perl-Clone-PP - Recursively copy Perl datatypes
perl-Code-TidyAll - Test::Code::TidyAll - Check that all your files are tidy and valid according to tidyall
perl-Color-Library - Easy-to-use and comprehensive named-color library
perl-Config-Any - Load configuration from different file formats, transparently
perl-Config-AutoConf - A module to implement some of AutoConf macros in pure perl
perl-Config-General - Generic Config Module
perl-Config-GitLike - Git-compatible config file parsing
perl-Config-INI - Perl module to work with simple .ini-file format
perl-Config-INI-Reader-Multiline - Parser for .ini files with line continuations
perl-Config-INI-Reader-Ordered - - .ini-file parser that returns sections in order
perl-Config-INI-Serializer - Round-trip INI serializer for nested data
perl-Config-Identity - Load (and optionally decrypt via GnuPG) user/pass identity information
perl-Config-IniFiles - Config-IniFiles - A module for reading .ini-style configuration files
perl-Config-IniHash - Perl extension for reading and writing INI files
perl-Config-MVP - Perl module to work with multivalue-property INI files
perl-Config-MVP-Reader-INI - an MVP config reader for .ini files
perl-Config-MVP-Slicer - Perl module to extract embedded plugin config from parent config
perl-Config-Mini - Very simple INI-style configuration parser
perl-Config-Simple - Simple configuration file class
perl-Config-Std - Perl module for work with configuration files
perl-Config-Tiny - Read/Write .ini style files with as little code as possible
perl-Config-YAML - Perl module Config::YAML - simple configuration automation
perl-ConfigReader - Read directives from a configuration file
perl-ConfigReader-Simple - Read simple configuration file formats
perl-Const-Fast - Facility for creating read-only scalars, arrays, and hashes
perl-Consul - Perl client library for Consul
perl-Context-Preserve - run code after a subroutine call, preserving the context the subroutine would have seen if it were the last statement in the caller
perl-Contextual-Return - Create context-sensitive return values
perl-Convert-ASCII-Armour - Convert-ASCII-Armour - Convert binary octets into ASCII armoured messages
perl-Convert-ASN1 - Perl ASN.1 parser module
perl-Convert-BER - Encode/decoing of ASN.1 using BER rules
perl-Convert-Base64 - encoding and decoding of Base64 strings
perl-Convert-Bencode - Convert::Bencode - Functions for converting to/from bencoded strings
perl-Convert-BinHex - Extract data from Macintosh BinHex files
perl-Convert-BinHex-scripts - perl-Convert-BinHex scripts
perl-Convert-Color - Color space conversions and named lookups
perl-Convert-NLS_DATE_FORMAT - Convert Oracle NLS_DATE_FORMAT <-> strftime Format Strings
perl-Convert-PEM - Convert-PEM - Read/write encrypted ASN.1 PEM files
perl-Convert-TNEF - Convert-TNEF (module for perl)
perl-Convert-UU - Perl module for uuencode and uudecode
perl-Convert-Wiki - Convert HTML/POD/txt from/to Wiki code
perl-Cookie-Baker - Cookie string generator / parser
perl-Courriel - Perl module for high level email parsing and manipulation
perl-Cpanel-JSON-XS-scripts - Cpanel-JSON-XS scripts
perl-Crypt-Blowfish_PP - Blowfish encryption algorithm implemented purely in Perl
perl-Crypt-CAST5_PP - Crypt-CAST5_PP - CAST5 block cipher in pure Perl
perl-Crypt-CBC - Crypt-CBC - Encrypt Data with Cipher Block Chaining Mode
perl-Crypt-DES_EDE3 - Crypt-DES_EDE3 - Triple-DES EDE encryption/decryption
perl-Crypt-DH - Diffie-Hellman key exchange system
perl-Crypt-DSA - Crypt-DSA - DSA signatures and key generation
perl-Crypt-GeneratePassword - generate secure random pronounceable passwords
perl-Crypt-OpenPGP - Pure-Perl OpenPGP-compatible PGP implementation
perl-Crypt-OpenPGP-scripts - perl-Crypt-OpenPGP scripts
perl-Crypt-OpenSSL-Guess - Guess OpenSSL include path
perl-Crypt-PBKDF2 - The PBKDF2 password hash algorithm
perl-Crypt-PasswdMD5 - Perl Crypt-PasswdMD5
perl-Crypt-Primes - Crypt-Primes - Provable Prime Number Generator suitable for Cryptographic Applications
perl-Crypt-RC4 - Perl implementation of the RC4 encryption algorithm
perl-Crypt-RC5 - Perl implementation of the RC5 encryption algorithm
perl-Crypt-RSA - RSA public-key cryptosystem
perl-Crypt-Random - Cryptographically Secure, True Random Number Generator
perl-Crypt-Random-Seed - Provide strong randomness for seeding
perl-Crypt-Random-Source - Get weak or strong random data from pluggable sources
perl-Crypt-Random-TESHA2 - Random numbers using timer/schedule entropy, aka userspace voodoo entropy
perl-Crypt-SaltedHash - Crypt::SaltedHash - Perl interface to functions that assist in working with salted hashes
perl-Crypt-Simple - encrypt stuff simply
perl-Crypt-SmbHash - lanman and nt md4 hash functions, for use in Samba style smbpasswd entries
perl-Crypt-TripleDES - Perl module Crypt-TripleDES implements 3DES encryption
perl-Crypt-URandom - Provide non blocking randomness
perl-Crypt-X509 - Parse a X.509 certificate
perl-Curses-UI - A curses based OO user interface framework
perl-Cwd-Guard - Temporary changing working directory (chdir)
perl-DBD-CSV - DBI driver for CSV files
perl-DBD-Cassandra - DBD database driver for Cassandra's CQL3
perl-DBD-Multi - Manage Multiple Data Sources with Failover and Load Balancing
perl-DBD-PgPP - perl module DBD-PgPP
perl-DBD-XBase - XBase driver for DBI interface in Perl
perl-DBICx-TestDatabase - Create a temporary database from a DBIx::Class::Schema
perl-DBIx-Abstract - DBI SQL abstraction
perl-DBIx-Class - Extensible and flexible object <-> relational mapper
perl-DBIx-Class-Cursor-Cached - Cursor class with built-in caching support
perl-DBIx-Class-DeploymentHandler - Extensible DBIx::Class deployment
perl-DBIx-Class-DynamicDefault - Automatically set and update fields
perl-DBIx-Class-InflateColumn-Object-Enum - Allows a DBIx::Class user to define a Object::Enum column
perl-DBIx-Class-IntrospectableM2M - Introspect many-to-many shortcuts
perl-DBIx-Class-OptimisticLocking - Optimistic locking support for DBIx::Class
perl-DBIx-Class-QueryLog - Log queries for later analysis.
perl-DBIx-Class-Schema-Config - Credential Management for DBIx::Class
perl-DBIx-Class-Schema-Loader - Dynamic definition of a DBIx::Class::Schema
perl-DBIx-Class-SingletonRows - make database rows returned by DBIx::Class
perl-DBIx-Class-TimeStamp - DBIx::Class extension to update and create date and time based fields
perl-DBIx-Class-Tutorial - DBIx::Class::Tutorial - tutorial for DBIx::Class
perl-DBIx-Class-WebForm - DBIx::Class::WebForm - CRUD Methods For DBIx::Class
perl-DBIx-Connector - Fast, safe DBI connection and transaction management
perl-DBIx-ContextualFetch - Add contextual fetches to DBI
perl-DBIx-DBSchema - Database-independent schema objects
perl-DBIx-Safe - Safe wrapper to DBI interface
perl-DBIx-SearchBuilder - Encapsulate SQL queries and rows in simple perl objects
perl-DBIx-Simple - Easy-to-use OO interface to DBI
perl-DBIx-XHTML_Table - perl module DBIx-XHTML_Table
perl-DIME-Tools - modules for parsing and generate DIME messages
perl-Daemon-Daemonize - An easy-to-use daemon(izing) toolkit
perl-Daemon-Generic - Daemon-Generic - Perl module
perl-Dancer - lightweight yet powerful web application framework
perl-Dancer-Plugin-Database - Dancer::Plugin::Database - easy database connections for Dancer applications
perl-Dancer-Plugin-Database-Core - Shared core for D1 and D2 Database plugins
perl-Dancer-Session-Cookie - Encrypted cookie-based session backend for Dancer
perl-Dancer-Template-Xslate - Dancer::Template::Xslate - Text::Xslate wrapper for Dancer
perl-Dancer2 - Lightweight yet powerful web application framework
perl-Danga-Socket - Event loop and event-driven async socket base class
perl-Data-Binary - Simple detection of binary versus text in strings
perl-Data-Buffer - Data-Buffer - Read/write buffer class
perl-Data-Compare - compare perl data structures
perl-Data-DPath - Magic functions available inside filter conditions
perl-Data-Denter - An alternative to Data::Dumper and Storable
perl-Data-Difflet - Ultra special pretty cute diff generator Mark II
perl-Data-Diver - Simple, ad-hoc access to elements of deeply nested structures
perl-Data-Dmp - Dump Perl data structures
perl-Data-Dump - Pretty printing of data structures
perl-Data-Dumper-Concise - Less indentation and newlines plus sub deparsing
perl-Data-Dumper-Perltidy - Dump and pretty print Perl data structures.
perl-Data-Entropy - Download entropy from
perl-Data-Float - Details of the floating point data type
perl-Data-FormValidator - Data::FormValidator - Validates user input (usually from an HTML form) based on input profile
perl-Data-GUID - Globally unique identifiers
perl-Data-HexDump - Hexadecial Dumper
perl-Data-Hierarchy - Handle data in a hierarchical structure
perl-Data-ICal - Generates iCalendar (RFC 2445) calendar files
perl-Data-Integer - details of the native integer data type
perl-Data-Localize - Data::Localize perl module
perl-Data-Munge - various utility functions
perl-Data-ObjectDriver - Simple, transparent data interface, with caching
perl-Data-OptList - Data-OptList - Perl module
perl-Data-Page - Data::Page - help when paging through sets of results
perl-Data-Page-Pageset - change long page list to be shorter and well navigate
perl-Data-Perl - Base classes wrapping fundamental Perl data types.
perl-Data-Printer - colored pretty-print of Perl data structures and objects
perl-Data-Random - Perl module to generate random data
perl-Data-Rmap - Recursive map, apply a block to a data structure
perl-Data-Section - Perl module to read multiple hunks of data out of DATA section
perl-Data-Section-Simple - Data::Section::Simple - Read data from __DATA__
perl-Data-Serializer - Data::Serializer - Modules that serialize data structures
perl-Data-Show - Dump data structures with name and point-of-origin
perl-Data-TreeDumper - dumps any data structure
perl-Data-TreeDumper-Renderer-GTK - Rendering plug-in for Data::TreeDumper
perl-Data-Types - Data-Types - validating and converting data types functions for Perl5
perl-Data-Uniqid - Perl extension for simple genrating of unique id's
perl-Data-Validate - Common data validation methods
perl-Data-Validate-Domain - Domain validation methods Perl module
perl-Data-Validate-IP - Perl IP address validation routines
perl-Data-Validate-URI - Common url validation methods
perl-Data-Validator - Rule based validator on type constraint system
perl-Data-Visitor - Data::Visitor - Visitor style traversal of Perl data structures
perl-Data-YAML - Easy YAML serialisation
perl-Date-Calc - Date-Calc module for perl
perl-Date-Extract - extract probable dates from strings
perl-Date-HolidayParser - Parser for .holiday-files
perl-Date-ICal - Perl extension for ICalendar date objects
perl-Date-Leapyear - Is a particular year a leap year?
perl-Date-Manip - Date manipulation routines
perl-Date-Manip-scripts - perl-Date-Manip scripts
perl-Date-Range - Work with a range of dates
perl-DateTime-Calendar-Julian - perl module DateTime-Calendar-Julian
perl-DateTime-Event-ICal - Perl DateTime extension for computing rfc2445 recurrences
perl-DateTime-Event-Recurrence - DateTime::Set extension for create basic recurrence sets
perl-DateTime-Format-Builder - DateTime::Format::Builder - create DateTime parser classes and objects
perl-DateTime-Format-DB2 - Parse and format DB2 dates and times
perl-DateTime-Format-DBI - Find a parser class for a database connection
perl-DateTime-Format-DateManip - Convert Date::Manip to DateTime and vice versa
perl-DateTime-Format-DateParse - Parses Date::Parse compatible formats
perl-DateTime-Format-Epoch - Convert DateTimes to/from epoch seconds
perl-DateTime-Format-Excel - Convert between DateTime and Excel dates
perl-DateTime-Format-Flexible - Flexibly parse strings and turn them into DateTime objects
perl-DateTime-Format-HTTP - DateTime::Format::HTTP - Date conversion routines
perl-DateTime-Format-IBeat - Format times in .beat notation
perl-DateTime-Format-ICal - Parse and format iCal datetime and duration strings
perl-DateTime-Format-ISO8601 - Perl module that parses ISO8601 formats
perl-DateTime-Format-Mail - Convert between DateTime and RFC2822/822 formats
perl-DateTime-Format-MySQL - Parse and format MySQL dates and times
perl-DateTime-Format-Natural - Create machine readable date/time with natural parsing logic
perl-DateTime-Format-Natural-Test - Common test routines/data for perl-DateTime-Format-Natural
perl-DateTime-Format-Oracle - Parse and format Oracle dates and timestamps
perl-DateTime-Format-Pg - Parse and format PostgreSQL dates and times
perl-DateTime-Format-RFC3339 - Parse and format RFC3339 datetime strings
perl-DateTime-Format-SQLite - Parse and format SQLite dates and times
perl-DateTime-Format-Strptime - Perl module to parse and format strp and strf time patterns
perl-DateTime-Format-W3CDTF - Parse and format W3CDTF datetime strings
perl-DateTime-Format-XSD - Format DateTime according to xsd:dateTime
perl-DateTime-Locale - Localization support for DateTime.pm
perl-DateTime-Set - Datetime sets and set math
perl-DateTime-TimeZone - Time zone object base class and factory
perl-DateTime-Tiny - Date object, with as little code as possible
perl-Debug-Client - debugger client side code for Padre, The Perl IDE.
perl-Devel-ArgNames - Figure out the names of variables passed into subroutines
perl-Devel-Autoflush - Set autoflush from the command line
perl-Devel-Backtrace - Object-oriented backtrace
perl-Devel-Caller-Perl - perl module Devel-Caller-Perl
perl-Devel-CheckBin - check that a command is available
perl-Devel-CheckCompiler - Check the compiler's availability
perl-Devel-CheckLib - check that a library is available
perl-Devel-CheckOS - Check what OS we're running on
perl-Devel-Comments - Debug with executable smart comments to logs
perl-Devel-Cover-scripts - perl-Devel-Cover scripts
perl-Devel-CoverX-Covered - Collect and report caller (test file) and
perl-Devel-CoverX-Covered-scripts - Devel-CoverX-Covered scripts
perl-Devel-Cycle - Devel::Cycle - Find memory cycles in objects
perl-Devel-DProfPP - Devel::DProfPP - Parse Devel::DProf output
perl-Devel-Dumpvar - Devel::Dumpvar - A pure-OO reimplementation of dumpvar.pl
perl-Devel-FindPerl - Find the path to your perl
perl-Devel-GlobalDestruction - Expose the flag which marks global destruction
perl-Devel-Hide - Forces the unavailability of specified Perl modules (for testing)
perl-Devel-OverloadInfo - introspect overloaded operators
perl-Devel-OverrideGlobalRequire - Override CORE::GLOBAL::require safely
perl-Devel-PDB - A simple Curses-based Perl Debugger
perl-Devel-PartialDump - Partial dumping of data structures, optimized for argument printing
perl-Devel-PatchPerl - Patch perl source a la Devel::PPPort's buildperl.pl
perl-Devel-PerlySense - Perl IDE backend with Emacs frontend.
perl-Devel-PerlySense-scripts - Devel-PerlySense scripts
perl-Devel-Platform-Info - Retrieve Solaris platform metadata
perl-Devel-REPL - Modern perl interactive shell
perl-Devel-REPL-Plugin-Completion - Devel-REPL plugin for tab completion
perl-Devel-REPL-Plugin-CompletionDriver-INC - Devel-REPL plugin for completing module names
perl-Devel-REPL-Plugin-CompletionDriver-Keywords - Devel-REPL plugin for completing keywords and operators
perl-Devel-REPL-Plugin-DDC - Devel-REPL plugin for formatting results with Data::Dumper::Concise
perl-Devel-REPL-Plugin-DDS - Devel-REPL plugin for formatting results with Data::Dump::Streamer
perl-Devel-REPL-Plugin-Interrupt - Devel-REPL plugin for trapping INT signal
perl-Devel-REPL-Plugin-LexEnv - Devel-REPL plugin for lexical environments
perl-Devel-REPL-Plugin-MultiLine-PPI - Devel-REPL plugin for multi-line blocks
perl-Devel-REPL-Plugin-Nopaste - Devel-REPL plugin for uploading data to a nopaste site
perl-Devel-REPL-Plugin-PPI - Devel-REPL plugin for dumping Perl code
perl-Devel-REPL-Plugin-Refresh - Devel-REPL plugin for reloading libraries
perl-Devel-Refactor - Perl extension for refactoring Perl code
perl-Devel-SelfStubber - Generate stubs for a SelfLoading module
perl-Devel-SimpleTrace - Perl module to die using stack traces
perl-Devel-SmallProf - per-line Perl profiler
perl-Devel-StackTrace - Devel::StackTrace - An object representing a stack trace
perl-Devel-StackTrace-AsHTML - Devel::StackTrace::AsHTML - Displays stack trace in HTML
perl-Devel-StackTrace-WithLexicals - Devel::StackTrace + PadWalker
perl-Devel-Symdump - Perl module for inspecting Perl's symbol table
perl-Devel-Trace - Print out each line before it is executed
perl-Devel-Trepan - A gdb-like debugger port of Ruby Trepan
perl-Devel-ebug - A simple, extensible Perl debugger
perl-Devel-ebug-scripts - Devel-ebug scripts
perl-Devel-ptkdb - Perl debugger using a Tk GUI
perl-Device-Gsm - Perl extension to interface GSM phones / modems
perl-Device-Modem - Perl extension to talk to modem devices connected via serial port
perl-Digest-Adler32 - The Adler-32 checksum
perl-Digest-BubbleBabble - Create bubble-babble fingerprints
perl-Digest-HMAC - Keyed-Hashing for Message Authentication
perl-Digest-MD5-File - Perl extension for getting MD5 sums for files and urls
perl-Digest-Perl-MD5 - Perl Implementation of Rivest's MD5 algorithm
perl-Digest-SHA3-scripts - Digest-SHA3 scripts
perl-Dir-Self - A __DIR__ constant for the directory your source file is in
perl-Directory-Scratch - Easy-to-use self-cleaning scratch space
perl-Directory-Scratch-Structured - creates temporary files and directories from a structured description
perl-Dist-CheckConflicts - declare version conflicts for your dist
perl-Dist-Zilla - scary tools for building CPAN distributions
perl-Dist-Zilla-Plugin-Bootstrap-lib - a minimal boot-strapping for Dist::Zilla Plug-ins
perl-Dist-Zilla-Plugin-Breaks - Add metadata about potential breakages caused by your distribution
perl-Dist-Zilla-Plugin-CheckChangesHasContent - Dist::Zilla plugin to ensure Changes has content before releasing
perl-Dist-Zilla-Plugin-CheckExtraTests - Dist::Zilla plugin to check xt tests before release
perl-Dist-Zilla-Plugin-CheckPrereqsIndexed - prevent a release if you have prereqs not found on CPAN
perl-Dist-Zilla-Plugin-Config-Git - Dist::Zilla plugin configuration for a Git repo
perl-Dist-Zilla-Plugin-ContributorsFile - Perl module to add a file listing all contributors
perl-Dist-Zilla-Plugin-DynamicPrereqs - Dist::Zilla plugin to specify dynamic prerequisites for distribution
perl-Dist-Zilla-Plugin-Git - Dist:Zilla plugin to Update git repository after release
perl-Dist-Zilla-Plugin-Git-Contributors - Dist::Zilla plugin to add contributor names from git
perl-Dist-Zilla-Plugin-GithubMeta - Dist:Zilla plugin to include GitHub meta information in META.yml
perl-Dist-Zilla-Plugin-MakeMaker-Awesome - a more awesome MakeMaker plugin for Dist::Zilla
perl-Dist-Zilla-Plugin-Meta-Contributors - Perl module to generate x_contributors section in distribution metadata
perl-Dist-Zilla-Plugin-MetaProvides - Generating and Populating 'provides' in META.yml
perl-Dist-Zilla-Plugin-MetaProvides-Package - Extract namespaces/version from traditional packages for provides
perl-Dist-Zilla-Plugin-NextVersion-Semantic - Perl module to semantic-wise update the next version
perl-Dist-Zilla-Plugin-OSPrereqs - List prereqs conditional on operating system
perl-Dist-Zilla-Plugin-OptionalFeature - Dist::Zilla plugin to specify prerequisites for optional features in distribution
perl-Dist-Zilla-Plugin-OurPkgVersion - Dist::Zilla plugin for package version management
perl-Dist-Zilla-Plugin-PodWeaver - weave Pod together from configuration and Dist::Zilla
perl-Dist-Zilla-Plugin-PromptIfStale - Dist::Zilla module to check at build/release time
perl-Dist-Zilla-Plugin-Run - Perl module to run commands at specific phases of Dist::Zilla
perl-Dist-Zilla-Plugin-TaskWeaver - a PodWeaver plugin used to build Task distributions
perl-Dist-Zilla-Plugin-Test-CPAN-Changes - Perl module to run release tests for changelog
perl-Dist-Zilla-Plugin-Test-CheckBreaks - Generate a test that shows what modules you are breaking
perl-Dist-Zilla-Plugin-Test-Kwalitee - Perl module with author tests for kwalitee
perl-Dist-Zilla-Plugin-Test-MinimumVersion - Release tests for minimum required versions
perl-Dist-Zilla-Plugin-Test-Perl-Critic - Dist::Zilla tests to check code against best practices
perl-Dist-Zilla-Plugin-Test-ReportPrereqs - Report on prerequisite versions during automated testing
perl-Dist-Zilla-PluginBundle-RJBS - BeLike::RJBS when you build your dists
perl-Dist-Zilla-Role-Bootstrap - Dist::Zilla module with shared logic for bootstrap things
perl-Dist-Zilla-Role-DynamicConfig - Dist::Zilla role that accepts a dynamic configuration
perl-Dist-Zilla-Role-ModuleMetadata - a role for plugins that use Module::Metadata
perl-Dist-Zilla-Role-PluginBundle-PluginRemover - Dist::Zilla plugin to a '-remove' functionality to a bundle
perl-Dist-Zilla-Role-RegisterStash - Dist::Zilla plugin that can register stashes
perl-Dist-Zilla-Role-Stash-Plugins - Dist::Zilla Stash that stores arguments for plugins
perl-Dist-Zilla-Stash-PodWeaver - Dist::Zilla plugin to stash of config options for Pod::Weaver
perl-Dist-Zilla-Util-ConfigDumper - A Dist::Zilla plugin configuration extraction utility
perl-Dist-Zilla-Util-Test-KENTNL - KENTNL's DZil plugin testing tool
perl-DistroMap - DistroMap - Perl interface for DistroMap database
perl-DublinCore-Record - DublinCore-Record - Perl module
perl-Dumbbench - Perl module for reliable benchmarking with the least amount of thinking
perl-DynaLoader-Functions - deconstructed dynamic C library loading
perl-Email-Abstract - unified interface to mail representations
perl-Email-Address - RFC 2822 Address Parsing
perl-Email-Address-List - RFC close address list parsing
perl-Email-Date - Find and Format Date Headers
perl-Email-Date-Format - Produce RFC 2822 date strings
perl-Email-Find - Email::Find - Find RFC 822 email addresses in plain text
perl-Email-Folder - Read all the messages from a folder as Email::Simple objects
perl-Email-FolderType - Email::FolderType - determine the type of a mail folder
perl-Email-MIME - Easy MIME message parsing
perl-Email-MIME-Attachment-Stripper - Strip the attachments from a mail
perl-Email-MIME-ContentType - Parse a MIME Content-Type Header
perl-Email-MIME-Encodings - A unified interface to MIME encoding and decoding
perl-Email-MessageID - Generate world unique message-ids
perl-Email-Outlook-Message - Read Outlook .msg files
perl-Email-Outlook-Message-scripts - Email-Outlook-Message scripts
perl-Email-Reply - Reply to a Message
perl-Email-Send - Simply Sending Email
perl-Email-Sender - A library for sending email
perl-Email-Simple - Simple parsing of RFC2822 message format and headers
perl-Email-Valid - Check validity of Internet email addresses
perl-Email-Valid-Loose - Email::Valid::Loose - Email::Valid which allows dot before at mark
perl-Enbugger-scripts - Enbugger scripts
perl-Encode-Escape - Perl extension for Encodings of various escape sequences
perl-Encode-IMAPUTF7 - Modification of UTF-7 encoding for IMAP
perl-Encode-InCharset - defines \p{InCharset}
perl-Encode-Locale - Determine the locale encoding
perl-Encode-Newlines - Normalize line ending sequences
perl-Encode-Registry - Encoding Registry module
perl-Encode-compat - Encode-compat - Encode.pm compatibility layer
perl-Env-Sanctify - Lexically scoped sanctification of %ENV
perl-Env-ShellWords - Environment variables for arguments as array
perl-Error - Error - Error/exception handling in an OO-ish way
perl-Eval-Closure - Safely and cleanly create closures via string eval
perl-Eval-Context - Evalute perl code in context wrapper
perl-Eval-LineNumbers - Add line numbers to hereis blocks that contain perl source code
perl-Eval-WithLexicals - Persist compile hints between evals
perl-Event-ExecFlow - Event::ExecFlow - High level API for event-based execution flow control
perl-Event-Notify - Simple Observer/Notifier
perl-Event-RPC - Event based transparent Client/Server RPC framework
perl-Excel-Template - creating MS Excel file from HTML::Template data structure
perl-Exception-Class - A module that allows you to declare real exception classes in Perl
perl-Exception-Class-DBI - Exception::Class::DBI - DBI Exception objects
perl-Exception-Class-TryCatch - Exception::Class::TryCatch - Syntactic try/catch sugar for use with Exception::Class
perl-Expect - Perl Expect interface
perl-Expect-Simple - wrapper around the Expect module
perl-Export-Attrs - The Perl 6 'is export(...)' trait as a Perl 5 attribute
perl-Exporter-Cluster - Perl extension for easy multiple module imports
perl-Exporter-Declare - Exporting done right
perl-Exporter-Lite - Exporter::Lite - Lightweight exporting of variables
perl-Exporter-Tidy - Perl module Exporter::Tidy
perl-Exporter-Tiny - an exporter with the features of Sub::Exporter but only core dependencies
perl-ExtUtils-CBuilder - Compile and link C code for Perl modules
perl-ExtUtils-CChecker - configure-time utilities for using C headers, libraries, or OS features
perl-ExtUtils-Config - A wrapper for perl's configuration
perl-ExtUtils-CppGuess - Guess C++ compiler and flags
perl-ExtUtils-Depends - Perl module for building XS extensions easily
perl-ExtUtils-F77 - Simple interface to F77 libs
perl-ExtUtils-H2PM - automatically generate perl modules to wrap C header files
perl-ExtUtils-Helpers - Various portability utilities for module builders
perl-ExtUtils-InstallPaths - Build.PL install path logic made easy
perl-ExtUtils-LibBuilder - A tool to build C libraries
perl-ExtUtils-MY_Metafile - META.yml customize with ExtUtil::MakeMaker
perl-ExtUtils-MakeMaker-CPANfile - cpanfile support for EUMM
perl-ExtUtils-PkgConfig - Perl interface to the pkg-config(1) command-line utility
perl-ExtUtils-Typemap - Read/Write/Modify Perl/XS typemap files
perl-ExtUtils-Typemaps-Default - Set of useful typemaps
perl-ExtUtils-XSBuilder - Perl extension for automatic Perl XS glue code generation
perl-ExtUtils-XSpp - ExtUtils-XSpp - Perl module
perl-FCGI-Client - FCGI::Client - client library for fastcgi protocol
perl-FCGI-EV - Perl FastCGI protocol implementation for use in EV-based applications
perl-FCGI-ProcManager - FCGI::ProcManager - A perl-based FastCGI process manager
perl-FFI-CheckLib - Check that a library is available for FFI
perl-Facebook-Graph - Perl interface to the Facebook Graph API
perl-Feed-Find - Syndication feed auto-discovery
perl-Fennec-Lite - Minimalist Fennec, the commonly used bits
perl-File-BOM - Utilities for handling Byte Order Marks
perl-File-BaseDir - Use the Freedesktop.org base directory specification
perl-File-ChangeNotify - Watch for changes to files, cross-platform style
perl-File-CheckTree - Run many file-test checks on a tree
perl-File-Copy-Recursive - Perl extension for recursively copying files and directories
perl-File-Copy-Recursive-Reduced - Recursive copying of files and directories within Perl 5 toolchain
perl-File-Corresponding - File::Corresponding - Find corresponding files in the directory tree
perl-File-Corresponding-scripts - perl-File-Corresponding scripts
perl-File-DesktopEntry - Object to handle .desktop files
perl-File-Fetch - A generic file fetching mechanism
perl-File-Find-Iterator - Iterator interface for search files
perl-File-Find-Object - an object oriented File::Find replacement
perl-File-Find-Object-Rule - alternative interface to File::Find::Object
perl-File-Find-Rule - Alternative interface to File::Find
perl-File-Find-Rule-Perl - Common rules for searching for Perl things
perl-File-Find-Rule-VCS - Exclude files/directories for Version Control Systems
perl-File-Finder - wrapper for File::Find module
perl-File-Flat - File::Flat - Implements a flat filesystem
perl-File-Flock - Wrapper for flock() to make file locking trivial
perl-File-HomeDir - Get the home directory for yourself or other users
perl-File-Inplace - Perl module for in-place editing of files
perl-File-KeePass - Perl interface to KeePass V1/V2 database files
perl-File-Listing - Parse directory listing
perl-File-Lock-ParentLock - File-Lock-ParentLock - share lock among child processes of given pid
perl-File-MMagic - Guess file type from contents
perl-File-MimeInfo - Determine file type
perl-File-MimeInfo-scripts - perl-File-MimeInfo scripts
perl-File-Modified - File::Modified - checks intelligently if files have changed
perl-File-NCopy - File-NCopy - Copy file, file
perl-File-NFSLock - File-NFSLock - perl module to do NFS (or not) locking
perl-File-Next - File-finding iterator
perl-File-Path-Tiny - recursive versions of mkdir() and rmdir() without as much overhead as File::Path
perl-File-PathInfo - Oo access to path variables stat data about a file on disk
perl-File-PathInfo-Ext - metadata files, renaming, some other things on top of PathInfo
perl-File-Pid - Pid File Manipulation
perl-File-Queue - Persistent FIFO queue implemented in pure perl
perl-File-ReadBackwards - Read a file backwards by lines
perl-File-Remove - Remove files and directories
perl-File-Rsync - Perl module interface to rsync
perl-File-SearchPath - Search for a file in an environment variable path
perl-File-Share - Extend File::ShareDir to Local Libraries
perl-File-ShareDir - Locate per-dist and per-module shared files
perl-File-ShareDir-Install - Perl extension for installing shared files
perl-File-ShareDir-ProjectDistDir - Simple set-and-forget using of a '/share' directory in your projects root
perl-File-Slurp - Efficient Reading/Writing of Complete Files
perl-File-Slurp-Tiny - A simple, sane and efficient file slurper
perl-File-Slurp-Unicode - File-Slurp-Unicode - Perl module
perl-File-Slurper - A simple, sane and efficient file slurper
perl-File-Tail - Perl extension for reading from continously updated files
perl-File-Tee - Replicate data sent to a Perl stream
perl-File-Touch - update access and modification timestamps, creating nonexistent files where necessary
perl-File-Type - File-Type - Perl module
perl-File-Which - Portable implementation of the `which' utility
perl-File-chdir - a more sensible way to change directories
perl-File-chmod - File::chmod - Implements symbolic and ls chmod modes
perl-File-pushd - Change directory temporarily for a limited scope
perl-FileHandle-Unget - FileHandle which supports multi-byte unget
perl-Filesys-Notify-Simple - Filesys::Notify::Simple - Simple and dumb file system watcher
perl-Filter-Simple - Simplified source filtering
perl-Filter-Template - Source filter for inline code templating
perl-Filter-signatures - very simplicistic signatures for Perl < 5.20
perl-Finance-Currency-Convert-Yahoo - Perl module to convert currencies using Yahoo
perl-Finance-Quote - Get stock and mutual fund quotes from various exchanges
perl-Finance-QuoteHist - Perl module for fetching historical stock quotes
perl-FindBin-libs - FindBin::libs - locate and a 'use lib' or export
perl-Font-AFM - Perl interface to Adobe Font Metrics files
perl-Font-TTF - TTF font support for Perl
perl-FormValidator-Lite - FormValidator::Lite perl module
perl-Format-Human-Bytes - Format::Human::Bytes - Format a bytecount and make it human readable
perl-FreezeThaw - Converting Perl structures to strings and back
perl-Frontier-RPC - Perl module for RPC over XML
perl-Functional-Utility - helper tools for light-weight functional programming.
perl-Future - represent an operation awaiting completion
perl-Future-IO - Future-returning IO methods
perl-GD-Barcode - Create barcode image with GD
perl-GD-Graph - Create charts using GD
perl-GD-Graph3d - Create 3D Graphs with GD and GD::Graph
perl-GD-SecurityImage - Security image (captcha) generator as perl module
perl-GD-Text - Text utilities for use with the GD drawing package
perl-GIS-Distance - Calculate geographic distances.
perl-GSM-SMS - Perl Modules For Smart Messaging
perl-Gear-Remotes - Gear-Remotes - Perl extension for quering Gear remotes files
perl-Gear-Rules - Gear-Rules - Perl extension for quering Gear rules files
perl-Gearman - Perl interface for Gearman distributed job system
perl-Gearman-Server - Function call router and load balancer
perl-Geo-Cache - Classes for dealing with GeoCaches and the related data files
perl-Geo-Coordinates-DecimalDegrees - Module to convert between degrees/minutes/seconds and decimal degrees
perl-Geo-Distance - Calculate Distances and Closest Locations
perl-Geo-GeoNames - Perform geographical queries using GeoNames Web Services
perl-Geo-Gpx - Geo-Gpx - Perl module
perl-Geo-IP-PurePerl - Geo::IP::PurePerl - Look up country by IP Address
perl-Geo-IPfree - Geo::IPfree - Look up country by IP Address
perl-Geography-Countries - Classes for 2-letter, 3-letter, and numerical codes for countries
perl-Geometry-AffineTransform - Affine Transformation to map 2D coordinates to other 2D coordinates
perl-Getargs-Long - Getargs-Long module for perl
perl-Getopt-ArgvFile - interpolates script options from files into @ARGV or another array
perl-Getopt-Euclid - Executable Uniform Command-Line Interface Descriptions
perl-Getopt-Long-Descriptive - Getopt::Long, but simpler and more powerful
perl-Getopt-Mixed - getopt processing with both long and short options
perl-Getopt-Std-Strict - Getopt-Std but option specs are passed at compile time
perl-Git-Repository - Git::Repository - Perl interface to Git repositories
perl-Git-Version-Compare - Functions to compare Git versions
perl-Git-Wrapper - Wrap git command-line interface
perl-GitLab-API-v4 - A complete GitLab API v4 client.
perl-GitLab-API-v4-scripts - GitLab-API-v4 scripts
perl-Glib-Object-Introspection-scripts - perl-Glib-Object-Introspection scripts
perl-GnuPG-Interface - Supply object methods for interacting with GnuPG
perl-Goo-Canvas-scripts - perl-Goo-Canvas scripts
perl-GooCanvas2 - Perl binding for GooCanvas2 widget using Glib::Object::Introspection
perl-Graph - Graph - Perl module for dealing with graphs
perl-Graph-Easy - Convert or render graphs as ASCII, HTML, SVG or via Graphviz
perl-Graph-Layout-Aesthetic-scripts - Graph-Layout-Aesthetic scripts
perl-Graph-ReadWrite - Graph::Reader::Dot - class for reading a Graph instance from Dot format
perl-GraphViz - Interface to the GraphViz graphing tool
perl-Graphics-ColorNames - Defines RGB values for common color names
perl-Growl-GNTP - Perl implementation of GNTP Protocol (Client Part)
perl-Gtk2-Ex-FormFactory - Makes building complex GUI's easy
perl-Gtk2-Ex-PodViewer - a Gtk2 widget for displaying POD documents
perl-Gtk2-Ex-PrintDialog - Perl dialog for printing data in GTK+ applications
perl-Gtk2-Ex-Simple-List - a simple interface to Gtk2's complex MVC list widget
perl-Gtk2-Ex-Simple-Tree - A simple interface to Gtk2's complex MVC tree widget
perl-Gtk2-GladeXML-Simple - A clean object-oriented interface to Gtk2::GladeXML
perl-Gtk3 - Perl interface to the 3.x series of the gtk+ toolkit
perl-Gtk3-ImageView - Image viewer widget for GTK 3
perl-Gtk3-SimpleList - A simple interface to Gtk3's complex MVC list widget
perl-Gtk3-WebKit - WebKit bindings for Perl
perl-HTML-BBReverse - HTML-BBReverse - Perl module
perl-HTML-Element-Extended - Perl extension for manipulating a table composed of HTML::Element style components
perl-HTML-Encoding - Determine the encoding of HTML/XML/XHTML documents
perl-HTML-Entities-Interpolate - Call HTML::Entities::encode_entities via a hash within a string
perl-HTML-FillInForm - HTML::FillInForm - Populates HTML Forms with data
perl-HTML-FillInForm-ForceUTF8 - FillInForm with utf8 encoding
perl-HTML-FillInForm-Lite - HTML::FillInForm::Lite - Fills in HTML forms with data
perl-HTML-Form - Class that represents an HTML form element
perl-HTML-FormFu - HTML Form Creation, Rendering and Validation Framework
perl-HTML-FormFu-MultiForm - Handle multi-page/stage forms
perl-HTML-FormatText-WithLinks - HTML to text conversion with links as footnotes
perl-HTML-FormatText-WithLinks-AndTables - Converts HTML to Text with tables in tact
perl-HTML-Formatter - Base class for HTML formatters
perl-HTML-FromANSI - Mark up ANSI sequences as HTML
perl-HTML-FromText - A perl module for HTML::FromText
perl-HTML-LinkExtractor - Extract links from an HTML document
perl-HTML-Lint - Check for HTML errors in a string or file
perl-HTML-Mason - HTML-Mason - Perl module
perl-HTML-Mason-PSGIHandler - PSGI handler for HTML::Mason
perl-HTML-Quoted - Extract structure of quoted HTML mail message
perl-HTML-RewriteAttributes - concise attribute rewriting
perl-HTML-Scrubber - HTML-Scrubber - Perl extension for scrubbing/sanitizing html
perl-HTML-Selector-XPath - CSS Selector to XPath compiler
perl-HTML-Shakan - HTML::Shakan - form html generator/validator
perl-HTML-SimpleParse - A bare-bones but effective HTML parser
perl-HTML-StickyQuery - HTML::StickyQuery - add sticky QUERY_STRING
perl-HTML-Table - Create HTML tables using simple interface
perl-HTML-TableExtract - HTML-TableExtract module for perl
perl-HTML-TagFilter - A fine-grained html-filter, xss-blocker and mailto-obfuscator
perl-HTML-Tagset - Data tables useful in dealing with HTML
perl-HTML-Template - Perl module to use HTML Templates from CGI scripts
perl-HTML-Template-Expr - Perl module to use expressions in HTML Template
perl-HTML-Template-JIT - A just-in-time compiler for HTML::Template
perl-HTML-Template-Parser - Parser for HTML::Template syntax template file & writer.
perl-HTML-Tiny - Lightweight, dependency free HTML/XML generation
perl-HTML-TokeParser-Simple - HTML-TokeParser-Simple - Perl module
perl-HTML-Tree - Perl modules for HTML syntax tree processing
perl-HTML-TreeBuilder-LibXML - HTML::TreeBuilder and XPath compatible interface with libxml
perl-HTML-TreeBuilder-XPath - Add XPath support to HTML::TreeBuilder
perl-HTML-Widget - HTML Widget And Validation Framework
perl-HTML-WikiConverter - An HTML to wiki markup converter
perl-HTML-WikiConverter-DokuWiki - Convert HTML to DokuWiki markup
perl-HTML-WikiConverter-Markdown - Convert HTML to Markdown markup
perl-HTML-WikiConverter-MediaWiki - Convert HTML to MediaWiki markup
perl-HTML-WikiConverter-MoinMoin - Convert HTML to MoinMoin markup
perl-HTML-WikiConverter-Socialtext - Convert HTML to Socialtext markup
perl-HTML-WikiConverter-TikiWiki - Convert HTML to TikiWiki markup
perl-HTML-WikiConverter-WakkaWiki - Convert HTML to WakkaWiki markup
perl-HTTP-Body - HTTP-Body - HTTP Body Parser
perl-HTTP-BrowserDetect - determine Web browser from an HTTP user agent string
perl-HTTP-Cache-Transparent - Cache the result of http get-requests persistently
perl-HTTP-CookieJar - A minimalist HTTP user agent cookie jar
perl-HTTP-Cookies - HTTP cookie jars
perl-HTTP-Daemon - a simple http server class
perl-HTTP-Date - Date conversion routines
perl-HTTP-Entity-Parser - PSGI compliant HTTP Entity Parser
perl-HTTP-Headers-Fast - Faster implementation of HTTP::Headers
perl-HTTP-Lite - HTTP::Lite - Lightweight HTTP implementation
perl-HTTP-Message - HTTP style messages
perl-HTTP-MultiPartParser - HTTP MultiPart Parser
perl-HTTP-Negotiate - choose a variant to serve
perl-HTTP-Proxy - A pure Perl HTTP proxy
perl-HTTP-ProxyAutoConfig - Unifed way to get the proxy information
perl-HTTP-Recorder - record interaction with websites
perl-HTTP-Request-AsCGI - HTTP::Request::AsCGI - Setup a CGI enviroment from a HTTP::Request
perl-HTTP-Request-Params - Retrieve GET/POST Parameters from HTTP Requests
perl-HTTP-Router - Yet Another Path Router for HTTP
perl-HTTP-Server-Simple - Lightweight HTTP server
perl-HTTP-Server-Simple-Authen - Authentication plugin for HTTP::Server::Simple
perl-HTTP-Server-Simple-Mason - A simple mason server
perl-HTTP-Server-Simple-PSGI - HTTP::Server::Simple::PSGI - PSGI handler for HTTP::Server::Simple
perl-HTTP-Session - HTTP::Session - simple session
perl-HTTP-Tiny - A small, simple, correct HTTP/1.1 client
perl-HTTP-Tiny-Multipart - Add post_multipart to HTTP::Tiny
perl-HTTPx-Dispatcher - the uri dispatcher(DEPRECATED)
perl-Hash-AsObject - Treat hashes as objects with accessors
perl-Hash-Case - base class for hashes with key-casing requirements
perl-Hash-Flatten - Flatten/unflatten complex data hashes
perl-Hash-Merge - Merges arbitrarily deep hashes into a single hash
perl-Hash-Merge-Simple - Recursively merge two or more hashes
perl-Hash-MoreUtils - Provide the stuff missing in Hash::Util
perl-Hash-MostUtils - Pairwise list manipulators
perl-Hash-MultiKey - hashes whose keys can be multiple
perl-Hash-MultiValue - Hash::MultiValue - Store multiple values per key
perl-Hash-Util-FieldHash-Compat - Use Hash::Util::FieldHash or ties, depending on availability
perl-Hash-WithDefaults - class for hashes with key-casing requirements supporting defaults
perl-Heap - Heap - Perl extensions for keeping data partially sorted
perl-Hook-LexWrap - Hook-LexWrap - Perl module
perl-I18N-Collate - compare 8-bit scalar data according to the current locale
perl-I18N-LangTags - Functions for dealing with RFC3066-style language tags
perl-IMAP-Admin - Perl module for basic IMAP server administration
perl-IO-AIO-scripts - perl-IO-AIO scripts
perl-IO-AIO-Util - aio_mkpath and aio_mktree functions missing from IO::AIO
perl-IO-All - IO::All of it to Graham and Damian!
perl-Future-IO-Impl-IOAsync - Future::IO Implementation using IO::Async
perl-IO-Async - Asynchronous event-driven programming
perl-IO-Capture - Abstract Base Class to build modules to capture output
perl-IO-Capture-Extended - Extend functionality of IO::Capture
perl-IO-CaptureOutput - Capture STDOUT and STDERR from Perl code, subprocesses or XS
perl-IO-Compress - Read and write compressed data
perl-IO-Compress-scripts - perl-IO-Compress scripts
perl-IO-Digest - Calculate digests while reading or writing
perl-IO-Event - Tied Filehandles for Nonblocking IO with Object Callbacks
perl-IO-File-String - load/save whole file as single string
perl-IO-HTML - Open an HTML file with automatic charset detection
perl-IO-Multiplex - IO::Multiplex - Manage IO on many file handles
perl-IO-Null - Class for null filehandles
perl-IO-Pager - Select a pager, optionally pipe it output if destination is a TTY
perl-IO-Pager-scripts - perl-IO-Pager scripts
perl-IO-Pipely - Portably create pipe() or pipe-like handles, one way or another.
perl-IO-Prompt-Tiny - Prompt for user input with a default option
perl-IO-Prompter - Prompt for input, read it, clean it, return it.
perl-IO-SessionData - supporting module for SOAP::Lite
perl-IO-Socket-INET6 - Object interface for AF_INET/AF_INET6 domain sockets
perl-IO-Socket-IP - IO::Socket::IP - A drop-in replacement for IO::Socket::INET supporting both IPv4 and IPv6
perl-IO-Socket-PortState - Perl extension for checking the open or closed status of a port
perl-IO-Socket-SSL - SSL socket interface class
perl-IO-Socket-Socks - This module seeks to provide a full implementation of the SOCKS protocol
perl-IO-Socket-Timeout - Perl IO::Socket with read/write timeout
perl-IO-Stream - Perl module for non-blocking I/O streams based on EV
perl-IO-String - IO::File interface emulation for in-core Perl strings
perl-IO-Stty - Change and print terminal line settings
perl-IO-Tee - Multiplex output to multiple output handles
perl-IO-TieCombine - Perl module to produce tied separate but combined variables
perl-IO-Zlib - IO:: style interface to Compress::Zlib
perl-IO-stringy - Filehandle-like I/O support for Perl in-core objects
perl-IP-Country - Classes for fast lookup of country codes from IP addresses for Perl
perl-IPC-Cmd - Finding and running system commands made easy
perl-IPC-Open3-Simple - A simple alternative to IPC::Open3
perl-IPC-Run - IPC-Run - system() and background procs w/ piping, redirs, ptys (Unix, Win32)
perl-IPC-Run-SafeHandles - IPC-Run-SafeHandles - Perl module
perl-IPC-Run3 - run a subprocess in batch mode (a la system) on Unix, Win32, etc.
perl-IPC-Shareable - IPC::Shareable - share Perl variables between processes
perl-IPC-Signal - Utility functions dealing with signals
perl-IPC-System-Options - Perl's system() and backtick/qx replacement/wrapper, with options
perl-IPC-System-Simple - Run commands simply, with detailed diagnostics
perl-IPTables-ChainMgr - Perl extension for manipulating iptables policies
perl-IPTables-Parse - Perl extension for parsing iptables firewall rulesets
perl-IRC-Utils - Common utilities for IRC-related tasks
perl-Ima-DBI - Database connection caching and organization
perl-Image-Base - Base class for image manipulation
perl-Image-Base-Other - Misc other helpers for Image::Base.
perl-Image-ExifTool - Perl module for manipulating EXIF data
perl-Image-Info - Extract meta information from image files
perl-Image-Math-Constrain - scaling math used in image size constraining
perl-Image-MetaData-JPEG - Perl extension for showing/modifying JPEG (meta)data
perl-Image-PNG-Libpng-scripts - Image-PNG-Libpng scripts
perl-Image-Size - Perl library for reading the dimensions of an image
perl-Image-Xbm - Load, create, manipulate and save xbm image files.
perl-Image-Xpm - Load, create, manipulate and save xpm image files
perl-Imager-Graph - producing Graphs using the Imager library
perl-Import-Into - import packages into other packages
perl-Importer - Alternative but compatible interface to modules that export symbols.
perl-Inline - Write Perl subroutines in other programming languages
perl-Inline-C - C Language Support for Inline
perl-Inline-Files - Multiple virtual files at the end of your code
perl-Iterator - A general-purpose iterator class
perl-Iterator-Simple - Simple iterator and utilities
perl-Iterator-Util - Essential utilities for the Iterator class
perl-JSON - Parse and convert to JSON (JavaScript Object Notation)
perl-JSON-Any - Wrapper Class for the various JSON classes
perl-JSON-MaybeXS - use L<Cpanel::JSON::XS> with a fallback to L<JSON::PP>
perl-JSON-PP - JSON::XS compatible pure-Perl module
perl-JSON-Parse-scripts - JSON-Parse scripts
perl-JSON-RPC - Perl implementation of JSON-RPC 1.1 protocol
perl-JSON-RPC-Server-Apache2 - JSON-RPC v1.1 mod_perl2 server
perl-JSON-RPC-Common - Transport agnostic JSON RPC helper objects
perl-JSON-Validator - Validate data against a JSON schema
perl-JSON-WebToken - JSON Web Token (JWT) implementation
perl-JavaScript-Beautifier - JavaScript::Beautifier - Beautify Javascript (beautifier for javascript)
perl-JavaScript-Minifier - JavaScript::Minifier - Perl extension for minifying JavaScript code
perl-JavaScript-Value-Escape - JavaScript::Value::Escape - Avoid XSS with JavaScript value interpolation
perl-Jcode - Japanese Charset Handler
perl-Jevix - HTML/XHTML filter and typograph for Perl
perl-Kwalify - Kwalify schema for data structures
perl-LEOCHARRE-Basename - very basic filename string and path operations such as ext and paths
perl-LEOCHARRE-CLI - perl module LEOCHARRE-CLI
perl-LEOCHARRE-CLI2 - Some quick help for writing cli scripts
perl-LEOCHARRE-DEBUG - deprecated
perl-LEOCHARRE-Debug - debug sub
perl-LEOCHARRE-Strings - Combines string procedures I frequently use
perl-LWP-Authen-Negotiate - GSSAPI based Authentication Plugin for LWP
perl-LWP-MediaTypes - Guess media type for a file or a URL
perl-LWP-Online - LWP::Online - Does your process have access to the web
perl-LWP-Protocol-PSGI - Override LWP's HTTP/HTTPS backend with your own PSGI applciation
perl-LWP-Protocol-https - Provide https support for LWP::UserAgent
perl-LWP-Protocol-socks - adds support for the socks protocol and proxy facility
perl-LWP-UserAgent-Determined - a virtual browser that retries errors
perl-LWPx-ParanoidAgent - subclass of LWP::UserAgent that protects you from harm
perl-LaTeX-ToUnicode - Convert LaTeX commands to Unicode
perl-Language-Expr - Simple minilanguage for use in expression
perl-Language-Logo - An implementation of the Logo programming language
perl-Lexical-Persistence - Persistent lexical variable values for arbitrary calls
perl-Lingua-CU - A Perl module for working with Church Slavonic text
perl-Lingua-EN-Fathom - Measure readability of English text
perl-Lingua-EN-FindNumber - Locate (written) numbers in English text
perl-Lingua-EN-Inflect - Convert singular to plural, select "a" or "an"
perl-Lingua-EN-Inflect-Number - Lingua::EN::Inflect::Number - Force number of words to singular or plural
perl-Lingua-EN-Inflect-Phrase - Inflect short English Phrases
perl-Lingua-EN-NameParse - Routines for manipulating a person's name
perl-Lingua-EN-Number-IsOrdinal - detect if English number is ordinal or cardinal
perl-Lingua-EN-Numbers - Turn "407" into "four hundred and seven", etc
perl-Lingua-EN-Numbers-Easy - Hash access to Lingua::EN::Numbers objects
perl-Lingua-EN-Numbers-Ordinate - Go from cardinal number (3) to ordinal ("3rd")
perl-Lingua-EN-Segmenter - Subdivide texts into passages that represent subtopics
perl-Lingua-EN-Sentence - Lingua-EN-Sentence - Module for splitting text into sentences
perl-Lingua-EN-Squeeze - Shorten text to minimum syllables by using hash table lookup and vowel deletion
perl-Lingua-EN-Syllable - perl module Lingua-EN-Syllable
perl-Lingua-EN-Tagger - Part-of-speech tagger for English natural language processing
perl-Lingua-EN-Words2Nums - convert English text to numbers
perl-Lingua-Identify - Language identification
perl-Lingua-JA-Regular-Unicode - Lingua::JA::Regular::Unicode - convert japanese chars
perl-Lingua-PT-Stemmer - Stemmers for Portuguese and Galician
perl-Lingua-Pere - Lingua-Pere - Scripts and modules for multilanguage translation.
perl-Lingua-Preferred - Perl extension to choose a language
perl-Lingua-RU-Antimat - Lingua::RU::Antimat - Perl Module for removal Russian slang from chat, guestbooks, etc.
perl-Lingua-Stem - Provides word stemming algorithms localized by language
perl-Lingua-Stem-Fr - Porter's stemming algorithm for French
perl-Lingua-Stem-It - Porter's stemming algorithm for Italian
perl-Lingua-Stem-Ru - Porter's stemming algorithm for Russian
perl-Lingua-Stem-Snowball-Da - Porters stemming algorithm for Denmark
perl-Lingua-Translit - Perl module to transliterate text between writing systems
perl-Linux-Input - Linux-Input - Perl module
perl-Linux-Smaps - a Perl interface to /proc/PID/smaps
perl-Linux-usermod - perl module Linux-usermod
perl-List-AllUtils - List-AllUtils - Perl module
perl-List-Compare - Compare elements of two or more lists
perl-List-MoreUtils - Provide the stuff missing in List::Util
perl-List-Pairwise - map/grep arrays and hashes pairwise
perl-List-PowerSet - perl module List-PowerSet
perl-List-SomeUtils - Provide the stuff missing in List::Util
perl-List-UtilsBy - Higher-order list utility functions
perl-Locale-Codes - ISO codes for countries, languages, currencies, and scripts
perl-Locale-Maketext - A framework for localization
perl-Locale-Maketext-Fuzzy - Locale-Maketext-Fuzzy - Maketext from already interpolated strings
perl-Locale-Maketext-Gettext - Joins the gettext and Maketext frameworks
perl-Locale-Maketext-Lexicon - Locale::Maketext::Lexicon - Use other catalog formats in Maketext
perl-Locale-Maketext-Simple - Simple interface to Locale::Maketext::Lexicon
perl-Locale-Msgfmt - Compile .po files to .mo files
perl-Locale-PO - Object-oriented interface to gettext po-file entries
perl-Locale-US - Map from US two-letter codes to states and vice versa
perl-LockFile-Simple - LockFile-Simple module for perl
perl-Log-Agent - Log-Agent module for perl
perl-Log-Any - Log::Any - bringing loggers and listeners together
perl-Log-Any-Adapter-Screen - Send logs to screen, with colors and some other features
perl-Log-Any-Adapter-TAP - Logger suitable for use with TAP test files
perl-Log-Any-IfLOG - Load Log::Any only if LOG environment variable is true
perl-Log-Channel - Log::Channel - yet another logging package
perl-Log-Contextual - Simple logging interface with a contextual log
perl-Log-Dispatch - Dispatches messages to one or more outputs
perl-Log-Dispatch-Array - log events to an array (reference)
perl-Log-Dispatch-Config - Log::Dispatch::Config - Log4j for Perl
perl-Log-Dispatch-DBI - Class for logging to database via DBI interface
perl-Log-Dispatch-FileRotate - Log to files that archive/rotate themselves
perl-Log-Dispatch-Perl - Log::Dispatch::Perl - Use core Perl functions for logging
perl-Log-Dispatchouli - a simple wrapper around Log::Dispatch
perl-Log-Log4perl - Log4j implementation for Perl
perl-Log-Log4perl-Appender-RRDs - Log-Log4perl backend - Log to a RRDtool Archive
perl-Log-Message - A generic message logging mechanism
perl-Log-Message-Simple - Simplified interface to Log::Message
perl-Log-Minimal - Minimal but customizable logger.
perl-Log-Report - Report a problem, pluggable handlers and language support
perl-Log-Report-Dancer - Log-Report plugin for Dancer
perl-Log-Report-Dancer2 - Log-Report plugin for Dancer2
perl-Log-Report-Optional - Log::Report in the lightest form
perl-Log-Trace - A unified approach to tracing
perl-Log-ger - A lightweight, flexible logging framework
perl-Logger-Syslog - A simple wrapper over Sys::Syslog perl module
perl-Logoved-DB - perl library for Logoved framework and DB
perl-RPM-Source-Transformation-Logoved-Batch - libraary to fix packages in batch using FIXSCRIPT
perl-Logoved-Stream - Stream parser library for rpmbuild -v, hasher, beehive logs.
perl-Logoved-Stream-Listener-Repocop - Repocop listener for Logoved-Stream beehive log parser.
perl-Loop - Smart, Simple, Recursive Iterators for Perl programming
perl-MARC-Charset - convert MARC-8 encoded strings to UTF-8
perl-MARC-Lint - Perl extension for checking validity of MARC records
perl-MARC-Record - Perl extension for handling MARC records
perl-MCE - Many-Core Engine for Perl. Provides parallel processing capabilities.
perl-MDK-Common - Various simple Perl functions
perl-MIDI - MIDI module for perl
perl-MIME-Base32 - Base32 encoder/decoder
perl-MIME-Base64-URLSafe - Perl extension for encode/decode URLs
perl-MIME-Charset - Charset Informations for MIME
perl-MIME-EncWords - deal with RFC 2047 encoded words (improved)
perl-MIME-Lite - Low-calorie MIME generator
perl-MIME-Lite-TT - TT enabled MIME::Lite wrapper
perl-MIME-Lite-TT-HTML - Create html mail with MIME::Lite and TT
perl-MIME-Types - Definition of MIME types
perl-MojoX-MIME-Types - Definition of MIME types for Mojolicious
perl-MIME-tools - Perl modules for parsing and creating MIME entities
perl-MLDBM - Multi-level hash structure storage for Perl
perl-MMS-Mail-Message - A class representing an MMS (or picture) message sent via email
perl-MP3-Info - Manipulate / fetch info from MP3 audio files
perl-MP3-Tag - Module for reading tags of MP3 audio files
perl-MPlayer - A perl module for MPlayer control
perl-MRO-Compat - mro::* interface compatibility for Perls < 5.9.5
perl-Mail-AuthenticationResults - Object Oriented Authentication-Results header class
perl-Mail-Box - Manage a mailbox, a folder with messages
perl-Mail-CheckUser - check email addresses for validity
perl-Mail-DKIM - Perl module for DKIM-based mail-signing and -verifying
perl-Mail-DomainKeys - A perl implementation of DomainKeys
perl-Mail-GnuPG - Process email with GPG
perl-Mail-IMAPClient - This module provides methods implementing the IMAP protocol
perl-Mail-Mbox-MessageParser - A fast and simple mbox folder reader
perl-Mail-Message - MIME message handling
perl-Mail-Message-Attachment-Stripper - Strip the attachments from a mail
perl-Mail-POP3Client - Mail-POP3Client module for perl
perl-Mail-SPF - Perl module that implements Sender Policy Framework
perl-Mail-SPF-Query - Mail-SPF-Query perl module
perl-Mail-SPF-Test - Perl module for reading and manipulating SPF test-suite data
perl-Mail-Sender - Perl module for sending mails with attachments through an SMTP server
perl-Mail-Sendmail - Simple platform independent mailer
perl-Mail-Transport - Email message exchange
perl-MailTools - Perl modules related to mail applications
perl-Makefile-DOM - Simple DOM parser for Makefiles
perl-Makefile-Parser - Simple parser for Makefiles
perl-Mango - Pure-Perl non-blocking I/O MongoDB driver
perl-Mason-Tidy - Tidy HTML::Mason/Mason components
perl-Math-Base-Convert - perl module Math-Base-Convert
perl-Math-Base36 - Encoding and decoding of base36 strings
perl-Math-Base85 - Perl extension for base 85 numbers, as referenced by RFC 1924
perl-Math-BaseCalc - Math-BaseCalc perl module
perl-Math-BaseCnv - Perl module with functions to convert between number bases
perl-Math-BigInt - Arbitrary size integer math package
perl-Math-BigRat - Arbitrarily big rational numbers
perl-Math-Calc-Units - Human-readable unit-aware calculator
perl-Math-Combinatorics - Perform combinations and permutations on lists
perl-Math-Complex - Math::Complex - complex numbers and associated mathematical functions
perl-Math-ContinuedFraction - Create and Manipulate Continued Fractions.
perl-Math-Expression-Evaluator - Parses, compiles and evaluates mathematics expressions
perl-Math-Fibonacci - Fibonacci numbers
perl-Math-HashSum - Sum a list of key-value pairs on a per-key basis
perl-Math-Matrix - Matrix data type (transpose, multiply etc)
perl-Math-MatrixReal - Manipulate matrix of reals
perl-Math-NumSeq - Number sequences
perl-Math-PlanePath - Mathematical paths through the 2-D plane
perl-Math-Polygon - Polygon calculations
perl-Math-Polynomial - Perl class for polynomials in one variable
perl-Math-Polynomial-Horner - Stringizing Math::Polyomial objects in Horner form.
perl-Math-Primality - Check for primes with Perl
perl-Math-Primality-scripts - Math-Primality scripts
perl-Math-Prime-Util-scripts - Math-Prime-Util scripts
perl-Math-Random-ISAAC - Perl interface to the ISAAC PRNG algorithm
perl-Math-Random-Secure - Cryptographically-secure, cross-platform replacement for rand()
perl-Math-Round - Perl extension for rounding numbers
perl-Math-Sequence - Perl extension dealing with mathematic sequences
perl-Math-Symbolic - Symbolic calculations
perl-Math-Symbolic-Custom-Pattern - Pattern matching on Math::Symbolic trees
perl-Math-Symbolic-Custom-Simplification - perl module Math-Symbolic-Custom-Simplification
perl-Math-Symbolic-Custom-Transformation - Transform Math::Symbolic trees
perl-Math-Telephony-ErlangB - Erlang B calculations from Perl
perl-Math-Telephony-ErlangC - Erlang C calculations in Perl
perl-Math-VecStat - Some basic numeric stats on vectors
perl-Math-Vector-SortIndexes - Sort the indices of a numeric vector
perl-MediaWiki-API - Provides a Perl interface to the MediaWiki API (http://www.mediawiki.org/wiki/API)
perl-Memoize - Perl functions speedup by caching return values
perl-Memoize-ExpireLRU - Expiry plug-in for Memoize that adds LRU cache expiration
perl-Meta-Builder - Tools for creating Meta objects to track custom metrics
perl-MetaCPAN-API - A comprehensive, DWIM-featured API to MetaCPAN
perl-MetaCPAN-Client - A comprehensive, DWIM-featured client to the MetaCPAN API
perl-Method-Signatures-Simple - Basic method declarations with signatures, without source filters
perl-Metrics-Any - abstract collection of monitoring metrics
perl-Minilla - CPAN module authoring tool
perl-Minion - Job queue
perl-Minion-Backend-SQLite - SQLite backend for Minion job queue
perl-Mixin-Linewise - Perl module to work with handle-like string objects
perl-Mo - Micro Objects. Mo is less.
perl-Mo-scripts - Mo scripts
perl-Mobile-UserAgent - Mobile user agent string parsing class
perl-Modern-Perl - Enable all of the features of Modern Perl with one command
perl-Module-Build - Build and install Perl modules
perl-Module-Build-Pluggable - Module::Build meets plugins
perl-Module-Build-Pluggable-PPPort - Generate ppport.h
perl-Module-Build-Tiny - A tiny replacement for Module::Build
perl-Module-Build-Using-PkgConfig - extend C<Module::Build> to more easily use platform libraries provided by F<pkg-config>
perl-Module-Build-WithXSpp - XS++ enhanced flavor of Module::Build
perl-Module-Build-XSUtil - A Module::Build class for building XS modules
perl-Module-CPANTS-Analyse - Generate Kwalitee ratings for a distribution
perl-Module-CPANfile - Parse cpanfile
perl-Module-CPANfile-scripts - Module-CPANfile scripts
perl-Module-Compile - Perl Module Compilation
perl-Module-CoreList - What modules shipped with versions of perl
perl-Module-Extract-Use - Perl module to pull out the modules a module explicitly uses
perl-Module-ExtractUse - Find out what Perl modules are used
perl-Module-Find - Module::Find - Find and use installed modules in a (sub)category
perl-Module-Implementation - Module::Implementation loads one of several alternate underlying implementations for a module
perl-Module-Info - Information about Perl modules
perl-Module-Install - Standalone, extensible Perl module installer
perl-Module-Install-AuthorRequires - Declare author-only dependencies
perl-Module-Install-AuthorTests - Module::Install::AuthorTests designate tests only run by module authors
perl-Module-Install-AutoManifest - generate MANIFEST automatically
perl-Module-Install-CheckLib - Module::Install::CheckLib - A Module::Install extension to check that a library is available
perl-Module-Install-ExtraTests - contextual tests that the harness can ignore
perl-Module-Install-ManifestSkip - Generate a MANIFEST.SKIP file
perl-Module-Install-ReadmeFromPod - Module::Install extension to automatically convert POD to a README
perl-Module-Install-Repository - Automatically sets repository URL from svn/svk/Git checkout
perl-Module-Install-TestBase - Module Install Support for Test::Base
perl-Module-Install-XSUtil - Module::Install::XSUtil - utility functions for XS modules
perl-Module-Load - runtime require of both modules and files
perl-Module-Load-Conditional - Looking up module information / loading at runtime
perl-Module-Loaded - Mark modules as loaded/unloaded
perl-Module-Locate - locate modules in the same fashion as "require" and "use"
perl-Module-Manifest - Module::Manifest - Parse and examine a Perl distribution MANIFEST file
perl-Module-Manifest-Skip - MANIFEST.SKIP Manangement for Modules
perl-Module-Metadata - Gather package and POD information from perl module files
perl-Module-Package - Postmodern Perl Module Packaging
perl-Module-Path - get the full path to a locally installed module
perl-Module-Path-scripts - Module-Path scripts
perl-Module-Pluggable - Automatically give your module the ability to have plugins
perl-Module-Pluggable-Fast - Fast plugins with instantiation
perl-Module-Refresh - Module-Refresh - Refresh INC files when updated on disk
perl-Module-Release - Automate Perl distribution releases
perl-Module-Release-scripts - Module-Release scripts
perl-Module-Runtime - Runtime module handling
perl-Module-ScanDeps - Recursively scan Perl programs for dependencies
perl-Module-Signature - Module-Signature module for perl
perl-Module-Starter - a simple starter kit for any module
perl-Module-Starter-PBP - Module::Starter::PBP - Create a module as recommended in "Perl Best Practices"
perl-Module-Starter-Plugin-SimpleStore - template storage methods for Module::Starter
perl-Module-Starter-Plugin-TT2 - TT2 templates for Module::Starter::Template
perl-Module-Starter-Smart - Add new modules into an existing distribution with this plugin
perl-Module-Util - Module::Util - Module name tools and transformations
perl-Module-Versions - Handle versions of loaded modules with flexible result interface
perl-Module-Versions-Report - Module-Versions-Report - report versions of all modules in memory
perl-Mojo-IOLoop-ReadWriteProcess - Execute external programs or internal code blocks as separate process
perl-Mojo-Pg - Mojolicious PostgreSQL
perl-Mojo-RabbitMQ-Client - Mojo::IOLoop based RabbitMQ client
perl-Mojo-SQLite - Tiny Mojolicious wrapper for SQLite
perl-MojoX-Renderer-Xslate - MojoX::Renderer::Xslate - Text::Xslate renderer for Mojo
perl-Mojolicious - Real-time web framework
perl-Mojolicious-Plugin-AssetPack - Compress and convert CSS, Less, Sass, JavaScript and CoffeeScript files
perl-Mojolicious-Plugin-Authentication - A plugin to make authentication a bit easier
perl-Mojolicious-Plugin-BasicAuth - helper for basic http authentication
perl-Mojolicious-Plugin-I18N - Mojolicious::Plugin::I18N - Internationalization Plugin for Mojolicious
perl-Mojolicious-Plugin-OAuth2 - A Mojolicious plugin that allows OAuth2 authentication
perl-Mojolicious-Plugin-RenderFile - Mojolicious plugin allowing customization to force file download
perl-Mojolicious-Plugin-TagHelpersExtra - Extra HTML tag plugins for Mojolicious Perl Web Framework, including link_to_here and table.
perl-MongoDB - Mongo Driver for Perl
perl-Monitoring-Plugin - A family of perl modules to streamline writing Naemon, Nagios,
perl-Moo - Moo - Minimalist Object Orientation (with Moose compatiblity)
perl-MooX-HandlesVia - NativeTrait-like behavior for Moo.
perl-MooX-Role-Parameterized - MooX::Role::Parameterized - roles with composition parameters
perl-MooX-Singleton - turn your Moo class into singleton
perl-MooX-TypeTiny - Optimized type checks for Moo + Type::Tiny
perl-MooX-Types-MooseLike - Perl module with some Moosish types and a type builder
perl-MooX-Types-MooseLike-Numeric - Moo types for numbers
perl-MooX-late - easily translate Moose code to Moo
perl-Moose-Autobox - Autoboxed wrappers for Native Perl datatypes
perl-MooseX - Document the MooseX namespace
perl-MooseX-Aliases - Easy aliasing of methods and attributes in Moose
perl-MooseX-App-Cmd - Mashes up MooseX::Getopt and App::Cmd
perl-MooseX-ArrayRef - blessed arrayrefs with Moose
perl-MooseX-Attribute-Chained - Attribute that returns the instance to allow for chaining
perl-MooseX-AttributeHelpers - Extended Moose attribute interfaces
perl-MooseX-AttributeShortcuts - Perl module to shorthand for common attribute options
perl-MooseX-AuthorizedMethods - Syntax sugar for authorized methods
perl-MooseX-ClassAttribute - Declare class attributes Moose-style
perl-MooseX-Clone - MooseX::Clone - fine grained cloning support for Moose objects
perl-MooseX-ConfigFromFile - An abstract Moose role for setting attributes from a configfile
perl-MooseX-Daemonize - Role for daemonizing your Moose based application
perl-MooseX-Declare - Declarative syntax for Moose
perl-MooseX-Emulate-Class-Accessor-Fast - Emulate Class::Accessor::Fast behavior using Moose attributes
perl-MooseX-Getopt - A Moose role for processing command line options
perl-MooseX-Has-Sugar - Sugar Syntax for moose 'has' fields
perl-MooseX-InsideOut - Inside-out objects with Moose
perl-MooseX-LazyRequire - Required attributes which fail only when trying to use them
perl-MooseX-Log-Log4perl - A Logging Role for Moose based on Log::Log4perl
perl-MooseX-MarkAsMethods - Mark overload code symbols as methods
perl-MooseX-Meta-TypeConstraint-ForceCoercion - Force coercion when validating type constraints
perl-MooseX-Meta-TypeConstraint-Mooish - Perl module for translating Moo-style constraints to Moose-style
perl-MooseX-Method-Signatures - Method declarations with type constraints and no source filter
perl-MooseX-MethodAttributes - code attribute introspection
perl-MooseX-NonMoose - Easy subclassing of non-Moose classes
perl-MooseX-Object-Pluggable - Make your Moose classes pluggable
perl-MooseX-OneArgNew - Perl module that teach ->new to accept single, non-hashref arguments
perl-MooseX-Params-Validate - an extension of Params::Validate for using Moose's types
perl-MooseX-Role-Parameterized - Roles with composition parameters
perl-MooseX-Role-Strict - use strict 'roles'
perl-MooseX-SemiAffordanceAccessor - Name your accessors foo() and set_foo()
perl-MooseX-SetOnce - Perl module to write-once, read-many attributes for Moose
perl-MooseX-StrictConstructor - Make your object constructors blow up on unknown attributes
perl-MooseX-TraitFor-Meta-Class-BetterAnonClassNames - metaclass for the MooseX::Util module
perl-MooseX-Traits - Automatically apply roles at object creation time
perl-MooseX-Traits-Pluggable - Trait loading and resolution for Moose
perl-MooseX-TransactionalMethods - Syntax sugar for transactional methods
perl-MooseX-Types - Organise your Moose types in libraries
perl-MooseX-Types-Common - A library of commonly used type constraints
perl-MooseX-Types-DateTime - DateTime related constraints and coercions for Moose
perl-MooseX-Types-JSON - JSON datatype for Moose
perl-MooseX-Types-LoadableClass - ClassName type constraint with coercion to load the class
perl-MooseX-Types-NetAddr-IP - NetAddr::IP related types and coercions for Moose
perl-MooseX-Types-Path-Class - A Path::Class type library for Moose
perl-MooseX-Types-Path-Tiny - Path::Tiny types and coercions for Moose
perl-MooseX-Types-Perl - Moose types that check against Perl syntax
perl-MooseX-Types-Stringlike - Moose type constraints for strings or string-like objects
perl-MooseX-Types-Structured - Structured Type Constraints for Moose
perl-MooseX-Types-URI - URI related types and coercions for Moose
perl-MooseX-Util - Perl module with Moose::Util extensions
perl-MouseX-App-Cmd - Mashes up MouseX::Getopt and App::Cmd
perl-MouseX-ConfigFromFile - An abstract Mouse role for setting attributes from a configfile
perl-MouseX-Foreign - MouseX::Foreign - Extends non-Mouse classes as well as Mouse classes
perl-MouseX-Getopt - Mouse role for processing command line options
perl-MouseX-SimpleConfig - A Mouse role for setting attributes from a simple configfile
perl-MouseX-Types - Organize your Mouse types in libraries
perl-MouseX-Types-Path-Class - A Path::Class type library for Mouse
perl-MouseX-Types-URI - A URI type library for Mouse
perl-Mozilla-CA - Perl module provides CA cert bundle
perl-NEXT - A pseudo-class NEXT that allows method redispatch
perl-NNTPClient - NNTPClient module for perl (News)
perl-NTLM - An NTLM authentication Perl module
perl-Net-AMQP - Advanced Message Queue Protocol (de)serialization and representation
perl-Net-Amazon - Framework for accessing amazon.com via REST
perl-Net-Amazon-EC2 - Perl interface to the Amazon Elastic Compute Cloud (EC2)
perl-Net-Async-CassandraCQL - use Cassandra databases with IO::Async using CQL
perl-Net-BitTorrent - Net-BitTorrent - Perl module
perl-Net-BitTorrent-scripts - perl-Net-BitTorrent scripts
perl-Net-CIDR - Manipulate IPv4/IPv6 netblocks in CIDR notation
perl-Net-CIDR-Lite - Perl extension for merging IPv4 or IPv6 CIDR addresses
perl-Net-DNS - Net::DNS is a DNS resolver implemented in Perl
perl-Net-DNS-Codes - Net::DNS::Codes - collection of C library DNS codes
perl-Net-DNS-Resolver-Programmable - Perl module that implements a programmable DNS resolver class for offline emulation of DNS
perl-Net-DRI - A Perl library to access Domain Name Registries/Registrars
perl-Net-Daemon - Perl extension for portable daemons
perl-Net-Domain-TLD - Gives ability to retrieve currently available TLD
perl-Net-EPP - Perl interface to EPP
perl-Net-EPP-Proxy - A proxy server for the EPP protocol
perl-Net-FastCGI - Net::FastCGI - FastCGI Toolkit
perl-Net-Flow - decode and encode NetFlow/IPFIX datagrams
perl-Net-Flow-Ie - decode NetFlow/IPFIX information elements
perl-Net-Google - Net-Google - Perl module
perl-Net-Google-AuthSub - Net-Google-AuthSub - Perl module
perl-Net-Graphite - Perl module with interface for Graphite
perl-Net-HTTP - Low-level HTTP connection (client)
perl-Net-HTTPS - Low-level HTTP connection (client)
perl-Net-IDN-Nameprep - Perl module implements IDN nameprep specification
perl-Net-IMAP-Simple - Perl extension for simple IMAP account handling
perl-Net-IMAP-Simple-SSL - Perl extension for adding SSL support for NEt::IMAP::Simple
perl-Net-INET6Glue - Make common modules IPv6 ready by hotpatching
perl-Net-IP - Perl extension for manipulating IPv4/IPv6 addresses
perl-Net-IP-Match - Efficiently match IP addresses against IP ranges
perl-Net-IP-Match-Regexp - Efficiently match IP addresses against IP ranges
perl-Net-IPv4Addr - Perl modules to manipulates Ipv4 addresses
perl-Net-IPv6Addr - - check validity of IPv6 addresses
perl-Net-Jabber - Net::Jabber - Jabber Perl Library
perl-Net-LDAP-SID - Active Directory Security Identifier manipulation
perl-Net-LDAP-Server - LDAP server side protocol handling
perl-Net-LDAP-Server-Test - Test Net::LDAP code
perl-Net-Libdnet-scripts - perl-Net-Libdnet scripts
perl-Net-NBsocket - Net::NBsocket - Non-Blocking Sockets
perl-Net-Nessus - Net-Nessus - Perl module
perl-Net-Netmask - Perl module for manipulation and lookup of IP network blocks
perl-Net-Nslookup - Provide nslookup(1)-like capabilities
perl-Net-OAuth - Perl module that provides OAuth protocol support
perl-Net-OpenID-Common - Libraries shared between Net::OpenID::Consumer and Net::OpenID::Server
perl-Net-OpenID-Consumer - Library for consumers of OpenID identities
perl-Net-OpenID-JanRain - OpenID Server and Consumer with JanRain API
perl-Net-OpenSSH - Net::OpenSSH - Perl SSH client package implemented on top of OpenSSH
perl-Net-Packet - A framework to easily send and receive frames from layer 2 to layer 7
perl-Net-Pcap-Easy - Net::Pcap is awesome, but it's difficult to bootstrap
perl-Net-Pcap-Reassemble - IP fragment reassembly for Net::Pcap
perl-Net-Ping - Check a remote host for reachability
perl-Net-RBLClient - Parallel RBL lookup client
perl-Net-RTP - Net-RTP - Send and receive RTP packets
perl-Net-RTP-scripts - perl-Net-RTP scripts
perl-Net-RabbitFoot - An Asynchronous and multi channel Perl AMQP client.
perl-Net-RabbitFoot-scripts - perl-Net-RabbitFoot scripts
perl-Net-Radius - Net-Radius - Perl module
perl-Net-SFTP - Secure File Transfer Protocol client
perl-Net-SFTP-Foreign - SSH File Transfer Protocol client
perl-Net-SIP - Perl framework for SIP (Voice Over IP, RFC3261)
perl-Net-SMPP - Perl implementation of SMPP over TCP
perl-Net-SMTP-SSL - SSL support for Net::SMTP
perl-Net-SMTP-TLS - An SMTP client supporting TLS and AUTH
perl-Net-SMTPS - SSL/STARTTLS support for Net::SMTP
perl-Net-SMTP_auth - SMTP_AUTH wrapper for Net::SMTP (rfc2554)
perl-Net-SNMP - Net::SNMP (module for perl) - Object oriented interface to SNMP
perl-Net-SNMP-scripts - perl-Net-SNMP scripts
perl-Net-SSH - Perl extension for secure shell
perl-Net-SSH-Expect - SSH wrapper to execute remote commands
perl-Net-Server - Net::Server - Extensible, general Perl server engine
perl-Net-Server-scripts - perl-Net-Server scripts
perl-Net-Server-Mail - Class to easily create a mail server
perl-Net-Shared - Shared variables across processes that are either local or remote.
perl-Net-Stomp - Net::Stomp - a Streaming Text Orientated Messaging Protocol Client
perl-Net-Subnet - Fast IP-in-subnet matcher for IPv4 and IPv6, CIDR or mask.
perl-Net-Syslogd - Perl implementation of Syslog Listener
perl-Net-Syslogd-scripts - perl-Net-Syslogd scripts
perl-Net-TFTP - Net::TFTP - TFTP Client class
perl-Net-Telnet - Script telnetable connections
perl-Net-Twitter - A perl interface to the Twitter API
perl-Net-Twitter-Lite - a Perl interface to the Twitter API
perl-Net-UPnP - Perl extension for UPnP
perl-Net-Write - a portable interface to open and send raw data to network
perl-Net-XMPP - XMPP Perl library
perl-Net-XWhois - Whois Client Interface for Perl5
perl-Net-Yadis - Net-Yadis - Perl module
perl-NetPacket - A cluster of modules related to decoding and encoding of network protocols.
perl-NetPacket-IPv6 - IPv6 modules (v0.020) for NetPacket
perl-NetxAP - NetxAP - Perl module
perl-Nmap-Parser - Parse nmap scan data with perl
perl-Nodejs-Util - Utilities related to Node.js
perl-Number-Bytes-Human - Perl extension for convert byte count to human readable format
perl-Number-Compare - Number-Compare - numeric comparisons
perl-Number-Format - Perl module converts numbers to strings with pretty formatting
perl-Number-Fraction - Perl extension to model fractions
perl-Number-Misc - Number::Misc - handy utilities for numbers
perl-Number-Tolerant - tolerance ranges for inexact numbers
perl-Number-WithError - real numbers with error propagation and scientific rounding
perl-OLE-Storage_Lite - Simple Class for OLE document interface
perl-ORLite - ORLite - Extremely light weight SQLite-specific ORM
perl-ORLite-Migrate - ORLite::Migrate - Extremely light weight SQLite-specific schema
perl-Object-Accessor - Per object accessors
perl-Object-Container - Object::Container - simple object container
perl-Object-Enum - Perl Enum Replacement
perl-Object-Event - Object::Event - A class that provides an event callback interface
perl-Object-Pluggable - A base class for creating plugin-enabled objects
perl-Object-Realize-Later - Delayed realization of objects
perl-Object-Remote - Call methods on objects in other processes or on other hosts
perl-Object-Remote-scripts - Object-Remote scripts
perl-Object-Signature - Object::Signature - Generate cryptographic signatures for objects
perl-Ogg-Vorbis-Header-PurePerl - An object-oriented interface to Ogg Vorbis
perl-OpenOffice-OODoc - OpenOffice-OODoc - A library for direct OpenOffice.org document processing
perl-OpenOffice-OODoc-scripts - perl-OpenOffice-OODoc scripts
perl-Ouch - Perl class for exception handling
perl-PAR - Perl Archive Toolkit
perl-PAR-Dist - PAR-Dist module for perl
perl-PBKDF2-Tiny - Minimalist PBKDF2 (RFC 2898) with HMAC-SHA1 or HMAC-SHA2
perl-PDF-API2 - Perl module for creation and modification PDF files
perl-PDF-API2-Simple - simplistic wrapper for the PDF::API2 modules
perl-PDF-Builder - Facilitates the creation and modification of PDF files
perl-PDF-Builder-examples - PDF-Builder examples
perl-PDF-ReportWriter - quality business reports, for archiving or printing
perl-PDF-Reuse - Reuse and mass produce PDF documents
perl-PDF-Reuse-Barcode - Create barcodes for PDF documents with PDF::Reuse
perl-PHP-Serialization - converts the output of PHP's serialize() into the equivalent Perl memory structure, and vice versa
perl-POD2-Base - POD2::Base - Base module for translations of Perl documentation
perl-POE - Portable multitasking and networking framework for any event loop
perl-POE-Component-Client-Asterisk-Manager - Event-based Asterisk / Aefirion Manager Client
perl-POE-Component-Client-DNS - Non-blocking/concurrent DNS queries using Net::DNS and POE
perl-POE-Component-Client-Ident - A component that provides non-blocking ident lookups to your sessions
perl-POE-Component-FastCGI - POE FastCGI server
perl-POE-Component-Generic - Generic non-blocking POE interface to any OO-module
perl-POE-Component-IKC - Inter-Kernel Communication for POE
perl-POE-Component-IRC - A fully event-driven IRC client dist
perl-POE-Component-Jabber - POE-Component-Jabber - Perl module
perl-POE-Component-Logger - A POE logging class
perl-POE-Component-Pluggable - A base class for creating plugin enabled POE Components
perl-POE-Component-PubSub - POE-Component-PubSub - Perl module
perl-POE-Component-SSLify - Makes using SSL in the world of POE easy!
perl-POE-Component-Syndicator - A POE component base class which implements the Observer pattern
perl-POE-Filter-IRCD - A POE-based parser for the IRC protocol
perl-POE-Filter-Stomp - Perl extension for the POE Environment
perl-POE-Filter-XML - XML parsing for the POE framework
perl-POE-Filter-Zlib - A POE filter wrapped around Compress::Zlib
perl-POE-Test-Loops - POE::Loop test suite
perl-POSIX-strftime-Compiler - GNU C library compatible strftime for loggers and servers
perl-PPI - Parse, Analyze and Manipulate Perl (without perl)
perl-PPI-HTML - Generate syntax-hightlighted HTML for Perl using PPI
perl-PPIx-EditorTools - PPIx::EditorTools - Utility methods and base class for manipulating Perl
perl-PPIx-QuoteLike - Parse Perl string literals and string-literal-like things.
perl-PPIx-Regexp - Represent a regular expression of some sort
perl-PPIx-Utilities - PPIx::Utilities - Extensions to PPI.
perl-PPIx-Utils - Utility functions for PPI
perl-Package - Parameterizable packages
perl-Package-Constants - List constants defined in a package
perl-Package-DeprecationManager - Manage deprecation warnings for your distribution
perl-Package-Generator - Package-Generator - Perl module
perl-Package-Stash - Routines for manipulating stashes
perl-Package-Variant - Parameterizable packages
perl-Padre - Padre - Perl Application Development and Refactoring Environment
perl-Palm - A set of modules for manupulating PalmOS databases
perl-Palm-PDB - Parse Palm database files
perl-Palm-ZText - Perl module and command line interface for work with zTXT documents of Palm readers
perl-Panotools-Script - Panorama Tools scripting
perl-Paper-Specs - Size and layout information for paper stock, forms, and labels
perl-Parallel-ForkManager - A simple parallel processing fork manager
perl-Parallel-Iterator - Simple parallel execution
perl-Parallel-Prefork - Simple prefork server framework
perl-Parallel-Scoreboard - Scoreboard for monitoring status of many processes
perl-Params-Check - A generic input parsing/checking mechanism.
perl-Params-Coerce - Allows your classes to do coercion of parameters
perl-Params-ValidationCompiler - Build an optimized subroutine parameter validator once, use it forever
perl-Paranoid - More secure programming in Perl
perl-Parse-AccessLogEntry - Parse one line of an Apache access log
perl-Parse-CPAN-Packages-Fast - Perl module to parse CPAN's package index
perl-Parse-DebControl - perl module Parse-DebControl
perl-Parse-EDID - Extended display identification data (EDID) parser
perl-Parse-ErrorString-Perl - parse error messages from the perl interpreter
perl-Parse-Functions - list all the functions in source code
perl-Parse-Method-Signatures - Perl6 like method signature parser
perl-Parse-PlainConfig - Plain Config parser
perl-Parse-RecDescent - Perl module for generating recursive-descent parsers
perl-Parse-Syslog - Parse-Syslog perl module
perl-Parse-Template - processor for templates containing Perl expressions
perl-Parse-Yapp - Parse-Yapp module for perl
perl-ParseLex - generator of lexical analyzers
perl-PatchReader - Utilities to read and manipulate patches and CVS
perl-Path-Class - Cross-platform path specification manipulation
perl-Path-FindDev - Find a development path somewhere in an upper hierarchy.
perl-Path-IsDev - Determine if a given Path resembles a development source tree
perl-Path-Iter - perl module Path-Iter
perl-Path-Iterator-Rule - Iterative, recursive file finder
perl-Path-Tiny - File path utility
perl-Pegex - Pegex Parser Generator
perl-Perl-Critic - Critique Perl source code for best-practices.
perl-Perl-Critic-Pulp - Some add-on perlcritic policies
perl-Perl-MinimumVersion - Find a minimum required version of perl for Perl code
perl-Perl-MinimumVersion-Fast - find a minimum required version of perl for Perl code
perl-Perl-OSType - Map Perl operating system names to generic types
perl-Perl-PrereqScanner - a tool to scan Perl code for its prerequisites
perl-Perl-PrereqScanner-NotQuiteLite - a tool to scan your Perl code for its prerequisites
perl-Perl-PrereqScanner-NotQuiteLite-scripts - Perl-PrereqScanner-NotQuiteLite scripts
perl-Perl-Tags - Generate (possibly exuberant) Ctags style tags for Perl sourcecode
perl-Perl-Tidy - Parses and beautifies perl source
perl-Perl-Tidy-Sweetened - Tweaks to Perl::Tidy to support some syntactic sugar
perl-Perl-Version - Perl module to parse and manipulate Perl version strings
perl-Perl4-CoreLibs - Libraries historically supplied with Perl 4
perl-Perl6-Junction - Perl6 style Junction operators in Perl5
perl-PerlIO-via-Timeout - a PerlIO layer that adds read & write timeout to a handle
perl-PerlIO-via-dynamic - Dynamic PerlIO layers
perl-PerlIO-via-symlink - PerlIO layers for create symlinks
perl-PerlX-Maybe - return a pair only if they are both defined
perl-PlRPC - Perl RPC (Remote Procedure Call)
perl-Plack - Plack - Perl Superglue for Web frameworks and Web Servers (PSGI toolkit)
perl-Plack-Apache2 - Apache 2.0 handlers to run PSGI application
perl-Plack-FCGI - FastCGI handler for Plack
perl-Plack-Middleware-Access - Middleware to restrict access depending on remote ip or other parameters.
perl-Plack-Middleware-Debug - The debug middleware offers a configurable set of panels that displays information about the current request and response.
perl-Plack-Middleware-ETag - Adds automatically an ETag header
perl-Plack-Middleware-FixMissingBodyInRedirect - Plack::Middleware which sets body for redirect response, if it's not already set
perl-Plack-Middleware-MethodOverride - Override REST methods to Plack apps via POST
perl-Plack-Middleware-RemoveRedundantBody - Plack::Middleware which sets removes body for HTTP response if it's not required
perl-Plack-Middleware-ReverseProxy - Plack::Middleware::ReverseProxy - supports app to run as a reverse proxy backend
perl-Plack-Middleware-Session - Plack::Middleware::Session - Middleware for session management
perl-Plack-Middleware-TemplateToolkit - Middleware to allow your Plack-based application to serve files processed through Template Toolkit (TT).
perl-Plack-Middleware-Test-StashWarnings - Test your application's warnings
perl-Plack-Test-ExternalServer - Run HTTP tests on external live servers
perl-Pod-Abstract - Abstract document tree for Perl POD documents
perl-Pod-Checker - Pod::Checker verifies POD documentation contents for compliance with the POD format specifications
perl-Pod-Coverage - Checks if the documentation of a module is comprehensive
perl-Pod-Coverage-TrustPod - Allow a module's pod to contain Pod::Coverage hints
perl-Pod-Elemental - Perl module to work with nestable Pod elements
perl-Pod-Elemental-PerlMunger - Perl module that takes a string of Perl and rewrites its documentation
perl-Pod-Elemental-Transformer-List - Perl module to transform :list regions in POD
perl-Pod-Escapes - Perl module for resolving Pod escape sequences
perl-Pod-Eventual - Perl module to read a POD document
perl-Pod-HTML2Pod - Translate HTML into POD
perl-Pod-LaTeX - Convert Pod data to formatted Latex
perl-Pod-Markdown - Convert POD to Markdown
perl-Pod-MinimumVersion - Perl version for POD directives used
perl-Pod-POM - Pod Object Model
perl-Pod-POM-View-Restructured - View for Pod::POM that outputs reStructuredText
perl-Pod-POM-View-Restructured-scripts - Pod-POM-View-Restructured scripts
perl-Pod-Parser - Modules for parsing/translating POD format documents
perl-Pod-Perldoc - perldoc is program for reading Pod documentation
perl-Pod-Readme - Intelligently generate a README file from POD
perl-Pod-Simple - Framework for parsing Pod
perl-Pod-Spell - A formatter for spellchecking Pod
perl-Pod-Strip - Remove POD from Perl code
perl-Pod-Tests - Extracts embedded tests and code examples from POD
perl-Pod-Tidy - Reformatting Pod Processor
perl-Pod-Usage - Pod::Usage extracts POD documentation and shows usage information
perl-Pod-Weaver - Perl module to weave together a Pod document from an outline
perl-Pod-Weaver-Section-Contributors - Pod:Weaver section listing contributors
perl-Pod-Wrap - Wrap pod paragraphs, leaving verbatim text and code alone
perl-PodToHTML - convert POD documentation to HTML
perl-PostScript-Simple - Produce PostScript files from Perl
perl-Privileges-Drop - A module to make it simple to drop all privileges, even POSIX groups.
perl-Probe-Perl - Information about the currently running perl
perl-Proc-Background - Generic interface to Unix and Win32 background process management
perl-Proc-ChildError - Explain process child error
perl-Proc-Daemon - Run Perl program as a daemon process
perl-Proc-Guard - process runner with RAII pattern
perl-Proc-InvokeEditor - Perl extension for starting a text editor
perl-Proc-PID-File - functions for manipulations with pidfiles
perl-Proc-PidUtil - Perl module: PID file management utilities
perl-Proc-Simple - Perl module Proc::Simple
perl-Proc-SyncExec - Perl module Proc::SyncExec
perl-Proc-WaitStat - Interpret and act on wait() status values
perl-Promises - An implementation of Promises in Perl
perl-Protocol-CassandraCQL - wire protocol support functions for Cassandra CQL
perl-Protocol-WebSocket - Protocol::WebSocket - WebSocket protocol
perl-REST-Client - A simple client for interacting with RESTful http/https resources
perl-RPC-XML - an implementation of XML-RPC
perl-RPM-Devscripts-Versort - RPM-Devscripts-Versort - rpm version comparator functions.
perl-RPM-Header-Alt - Alternative pure perl RPM header reader for ALTLinux fork of RPM
perl-RPM-Payload - Simple in-memory access to RPM cpio archive
perl-RPM-Source-BundleImport - RPM-Source-Editor extension for converting tarballs to SRPMs
perl-RPM-Source-BundleImport-Perl - RPM-Source-BundleImport plugin for Perl source code
perl-RPM-Source-Convert - RPM-Source-Convert - Perl extension for converting SRPM and spec files
perl-RPM-Source-Dependency-Analyzer - Perl library for finding build dependencies from software sources
perl-RPM-Source-Editor - Perl library for src.rpm and spec file editing
perl-RPM-Source-Update - RPM-Source-Editor extension for updating packages
perl-RPM-Specfile - RPM::Specfile - Perl extension for creating RPM Specfiles
perl-RPM-Vercmp - RPM-Vercmp - rpm version comparator functions.
perl-RPM-uscan - Perl library for querying debian watch files
perl-RRDTool-OO - RRDTool::OO - Object-oriented interface to RRDTool
perl-RTF-Tokenizer - RTF-Tokenizer - Tokenize RTF
perl-Readonly - Readonly - facility for creating read-only scalars, arrays, hashes
perl-Redis - Perl binding for Redis database
perl-Ref-Util - Perl utility functions for checking references
perl-Regexp-Assemble - Assemble multiple Regular Expressions into a single RE
perl-Regexp-Bind - Bind variables to captured buffers
perl-Regexp-Common - Regexp-Common - Provide commonly requested regular expressions
perl-Regexp-Common-WithActions - adds actions to Regexp::Common
perl-Regexp-Common-net-CIDR - Provide patterns for CIDR blocks
perl-Regexp-Grammars - Add grammatical parsing features to perl regular expressions
perl-Regexp-IPv6 - Regular expression for IPv6 addresses
perl-Regexp-Optimizer - optimizes regular expressions
perl-Regexp-Parser - base class for parsing regexes
perl-Regexp-Shellish - Shell-like regular expressions
perl-Regexp-Stringify - Stringify a Regexp object
perl-Regexp-Trie - perl module Regexp-Trie
perl-Reply - read, eval, print, loop, yay!
perl-Reply-scripts - Reply scripts
perl-Return-MultiLevel - return across multiple call levels
perl-Return-Value - Polymorphic Return Values
perl-Role-Basic - Just roles. Nothing else.
perl-Role-HasMessage - Perl module to provide a thing with an message method
perl-Role-Identifiable - Perl module to provide a thing with an ident attribute
perl-Role-Tiny - Role::Tiny - minimalist role composition tool
perl-Roman - Perl module for conversion between Roman and Arabic numerals.
perl-Router-Boom - Fast routing engine for web applications
perl-Router-Simple - Router::Simple perl module
perl-Router-Simple-Sinatraish - Router::Simple::Sinatraish - Sinatra-ish routers on Router::Simple
perl-RunApp - a module for streamlining applications / services startup.
perl-SGMLSpm - Perl library for parsing the output of nsgmls
perl-SMS-Send - Driver-based API for sending SMS messages
perl-SMS-Send-DeviceGsm - An SMS::Send driver for Device::Gsm
perl-SNMP-Simple - shortcuts for when using SNMP
perl-SNMP_Session - Native SNMP support for Perl 5
perl-SOAP-Lite - Perl's Web Services Toolkit
perl-SOAP-MIME - SOAP-MIME - Perl module
perl-SOAP-Transport-HTTP-Nginx - transport for nginx (http://nginx.net/) http server for SOAP::Lite module
perl-SOAP-WSDL - SOAP-WSDL provides a SOAP client with WSDL support
perl-SQL-Abstract - Generate SQL from Perl data structures
perl-SQL-Abstract-Classic - Generate SQL from Perl data structures
perl-SQL-Abstract-Limit - SQL::Abstract::Limit - portable LIMIT emulation
perl-SQL-Abstract-Pg - PostgreSQL features for SQL::Abstract
perl-SQL-Interp - perl module SQL-Interp
perl-SQL-SplitStatement - Split any SQL code into atomic statements
perl-SQL-Statement - SQL parsing and processing engine
perl-SQL-Tokenizer - Simple SQL tokenizer
perl-SQL-Translator - Manipulate structured data definitions (SQL and more)
perl-SRU - Search and Retrieve URL Service
perl-SUPER - Sane superclass method dispatcher
perl-SVG - SVG - Perl extension for generating Scalable Vector Graphics (SVG) documents
perl-SVG-Parser - XML Parser for SVG documents
perl-SVN-Look - Caching wrapper around the svnlook command
perl-SVN-Notify - Perl module for Subversion activity notification
perl-Safe-Isa - Call isa, can, does and DOES safely on things that may not be objects
perl-Schedule-At - OS independent interface to the Unix 'at' command
perl-Scope-Guard - lexically scoped resource management
perl-Sereal - Fast, compact, powerful binary (de-)serialization
perl-Server-Starter - Server::Starter - a superdaemon for hot-deploying server programs
perl-Session-Storage-Secure - Encrypted, expiring, compressed, serialized session data with integrity
perl-Set-Crontab - Expand crontab(5)-style integer lists
perl-Set-Infinite - Sets of intervals
perl-Set-IntSpan - Set::IntSpan - Manages sets of integers
perl-Set-IntSpan-Fast - Fast handling of sets containing integer spans.
perl-Set-Intersection - Get intersection (of set theory) of arrays
perl-Set-NestedGroups - grouped data eg ACL's, city/state/country etc
perl-Set-Scalar - Basic set operations
perl-Set-Tiny - Simple sets of strings
perl-Shell - Shell - run shell commands transparently within perl
perl-Shell-Config-Generate - Portably generate config for any shell
perl-Shell-Guess - Make an educated guess about the shell in use
perl-Signal-Mask - Signal masks made easy
perl-Smart-Args - argument validation for you
perl-Smart-Comments - Smart-Comments - Perl module
perl-Snowball-Norwegian - Porters stemming algorithm for Norwegian
perl-Snowball-Swedish - Porters stemming algorithm for Swedish
perl-Socket-GetAddrInfo - RFC 2553's getaddrinfo and getnameinfo functions
perl-Socket-GetAddrInfo-scripts - perl-Socket-GetAddrInfo scripts
perl-Software-License - Perl module that provide templated software licenses
perl-Software-License-CCpack - Software::License pack for Creative Commons' licenses
perl-Sort-Naturally - Sort::Naturally -- sort lexically, but sort numeral parts numerically
perl-Sort-Versions - Sort-Versions - a perl 5 module for sorting of revision-like numbers
perl-Source-Bundle - Source-Bundle - Perl extension for converting SRPM and spec files
perl-Source-Package - Source-Package - Perl extension for converting SRPM and spec files
perl-Source-Repository - Source-Repository - Perl extension for converting SRPM and spec files
perl-Source-Repository-Mass - Source-Repository-Mass - Perl extension for converting SRPM and spec files
perl-Source-Shared-CLI - Source-Shared-CLI - yet another framework for CLI module configuration
perl-Source-Shared-FindLocalMirror - Local Mirror locator for Source-Shared framework
perl-Source-Shared-Resource - Source-Shared-Resource - yet another framework for Resource module configuration
perl-Source-Shared-Utils - Source-Shared-Utils - a small collection of utils for Source-Shared
perl-Specio - Type constraints and coercions for Perl
perl-Specio-Library-Path-Tiny - Path::Tiny types and coercions for Specio
perl-Sphinx-Search - Sphinx search engine API Perl client
perl-Spiffy - Spiffy Perl Interface Framework For You
perl-Spreadsheet-ParseExcel - Extract information from Excel file
perl-Spreadsheet-ReadSXC - Extract OpenOffice 1.x spreadsheet data
perl-Spreadsheet-WriteExcel - Perl module for generating Excel97+ compatible Spreadsheets
perl-Spreadsheet-XLSX - perl module Spreadsheet-XLSX
perl-Starlet - Simple, high-performance PSGI/Plack HTTP server
perl-Statistics-Basic - A collection of very basic statistics modules
perl-Statistics-ChiSquare - perl module Statistics-ChiSquare
perl-Statistics-Contingency - Calculate precision, recall, F1, accuracy, etc.
perl-Statistics-Descriptive - Basic descriptive statistical functions
perl-Statistics-Distributions - Critical values and upper probabilities of common statistical distributions
perl-Statistics-TTest - Perl module to perform T-test on 2 independent samples
perl-Stream-Buffered - temporary buffer to save bytes
perl-String-BitCount - perl module String-BitCount
perl-String-CamelCase - CamelCase, de-camelcase
perl-String-Errf - Perl module to provide a simple sprintf-like dialect
perl-String-Escape - Perl module that provides conversion functions for escaped strings
perl-String-Flogger - string munging for loggers
perl-String-Format - Perl module for sprintf-like string formatting
perl-String-Formatter - Perl module to build sprintf-like functions of your own
perl-String-Koremutake - Convert to/from Koremutake Memorable Random Strings
perl-String-Parity - perl module String-Parity
perl-String-Prettify - subs to cleanup a filename and or garble for human eyes
perl-String-Print - printf extensions
perl-String-Random - Perl module to generate random strings based on a pattern
perl-String-RewritePrefix - Rewrite strings based on a set of known prefixes
perl-String-ShellQuote - quote strings for passing through the shell
perl-String-TT - use TT to interpolate lexical variables
perl-String-ToIdentifier-EN - Convert Strings to English Program Identifiers
perl-String-Tokenizer - A simple string tokenizer
perl-String-Truncate - Perl module for when strings are too long to be displayed in ...
perl-String-Util - String::Util -- String processing utilities
perl-Struct-Dumb - make simple lightweight record-like structures
perl-Sub-Delete - perl module Sub-Delete
perl-Sub-Exporter - a sophisticated exporter for custom-built routines
perl-Sub-Exporter-ForMethods - Perl module with helper routines for using Sub::Exporter
perl-Sub-Exporter-GlobExporter - export shared globs with Sub::Exporter collectors
perl-Sub-Exporter-Lexical - to export lexically-available subs with Sub::Exporter
perl-Sub-Exporter-Progressive - Sub::Exporter::Progressive - Only use Sub::Exporter if you need it
perl-Sub-HandlesVia - alternative handles_via implementation
perl-Sub-Info - Tool for inspecting Perl subroutines
perl-Sub-Install - install subroutines into packages easily
perl-Sub-Override - Perl extension for easily overriding subroutines
perl-Sub-Quote - efficient generation of subroutines via string eval
perl-Sub-Uplevel - Run a function in a higher stack frame
perl-Switch - A switch statement for Perl
perl-Symbol-Global-Name - finds name and type of a global variable
perl-Syntax-Highlight-Engine-Kate - Port to Perl of the syntax highlight engine of the Kate text editor
perl-Syntax-Highlight-Perl - perl module Syntax-Highlight-Perl
perl-Syntax-Highlight-Perl-Improved - Highlighting of Perl Syntactical Structures
perl-Syntax-Keyword-Junction - Perl6 style Junction operators in Perl5
perl-Sys-Hostname-Long - Sys-Hostname-Long perl module
perl-Sys-SigAction - Perl extension for Consistent Signal Handling
perl-Sys-Syscall - access system calls that Perl doesn't normally provide access to
perl-Sysadm-Install - Typical installation tasks for system administrators
perl-System-Command - System::Command - Object for running system commands
perl-TAP - The Test Anything Protocal
perl-TAP-DOM - Accessors for TAP::DOM summary part
perl-TAP-Formatter-HTML - TAP Test Harness output delegate for html output
perl-TAP-Harness-Archive - Create an archive of TAP test results
perl-TAP-SimpleOutput - simple closure-driven TAP generator
perl-TOML - Parser for Tom's Obvious, Minimal Language.
perl-TOML-Parser - simple toml parser
perl-Tapper - Automated OS testing, also virtualized
perl-Tapper-Base - Require that we are running on a particular OS
perl-Tapper-CLI - Tapper-* command line tools
perl-Tapper-Cmd - Tapper - Backend functions for CLI and Web
perl-Tapper-Config - Tapper - Context sensitive configuration hub for all Tapper libs
perl-Tapper-Installer - Tapper - Install everything needed for a test
perl-Tapper-Model - Tapper - Context sensitive connected DBIC schema
perl-Tapper-PRC - Control running test programs
perl-Tapper-Remote - Tapper - Common functionality for remote automation libs
perl-Tapper-Reports-API - Tapper - Remote network API for result evaluation
perl-Tapper-Reports-DPath - Extended DPath functionality for Tapper reports
perl-Tapper-Reports-Receiver - Receive test reports
perl-Tapper-Reports-Web - Tapper frontend web application based on Catalyst
perl-Tapper-Schema - Database schemas for Tapper
perl-Tapper-TAP-Harness - Tapper - Tapper specific TAP handling
perl-Tapper-TestSuite-AutoTest - Complete OS testing in a box via autotest for Tapper
perl-Tapper-TestSuite-HWTrack - Report hardware meta information
perl-Tapper-TestSuite-Netperf - Tapper - Network performance measurements - Client
perl-Task - Task - successor to Bundle:: for installing sets of modules
perl-Task-Weaken - Ensure that a platform has weaken support
perl-Telephony-CountryDialingCodes - Convert international dialing codes to country codes and vice versa
perl-Template-Alloy - TT2/3, HT, HTE, Tmpl, and Velocity Engine
perl-Template-Extract - Use TT2 syntax to extract data from documents
perl-Template-GD - GD plugins for the Template Toolkit
perl-Template-Plugin-Autoformat - TT plugin for Text::Autoformat
perl-Template-Plugin-EnvHash - Environment Variable Hash for TT2
perl-Template-Provider-DBIC - Template::Provider::DBIC - Load templates using DBIx::Class
perl-Template-Provider-Encoding - Explicitly declare encodings of your templates
perl-Template-Timer - Template::Timer - Rudimentary profiling for Template Toolkit
perl-Template-Tiny - Template::Tiny - Template Toolkit reimplemented in as little code as possible
perl-Template-Toolkit-Simple - Parameterizable packages
perl-Term-ANSIColor - Color output using ANSI escape sequences
perl-Term-Animation - ASCII sprite animation framework
perl-Term-Cap - Perl termcap interface
perl-Term-EditorEdit - Edit a document via $EDITOR
perl-Term-EditorEdit-scripts - Term-EditorEdit scripts
perl-Term-Encoding - Perl module to detect encoding of the current terminal
perl-Term-ProgressBar - Provides a progress meter on a standard terminal
perl-Term-ReadPassword - Asking the user for a password
perl-Term-ShellUI - Perl module to write a fully-featured shell-like CLI
perl-Term-Size-Any - Retrieve terminal size
perl-Term-Size-Perl - Perl extension for retrieving terminal size (Perl version)
perl-Term-Table - Format a header and rows into a table
perl-Term-UI - User interfaces via Term::ReadLine made easy
perl-Term-VT102 - Term::VT102 - a class to emulate a DEC VT102 terminal
perl-Term-VT102-Boundless - A L<Term::VT102> that grows automatically to
perl-Test-Assertions - Simple set of building blocks for both unit and runtime testing
perl-Test-Base - Data driven testing framework for perl
perl-Test-Block - Test::Block - Specify fine granularity test plans
perl-Test-CPAN-Meta - Validation of the META.yml file in a CPAN distribution
perl-Test-CPAN-Meta-JSON - Validate a META.json file within a CPAN distribution
perl-Test-CPAN-Meta-YAML - Validate a META.yml file within a CPAN distribution
perl-Test-CheckDeps - Check for presence of dependencies
perl-Test-Class - Easily create test classes in an xUnit/JUnit style
perl-Test-Class-Most - Test::Class::Most - Test Classes the easy way
perl-Test-ClassAPI - Provides basic first-pass API testing for large class trees
perl-Test-CleanNamespaces - Check for uncleaned imports
perl-Test-Cmd - Perl module for portable testing of commands and scripts
perl-Test-Compile - Check whether Perl module files compile correctly
perl-Test-ConsistentVersion - Ensures a CPAN distribution has consistent versioning
perl-Test-Database - Database handles ready for testing
perl-Test-Deep - Test-Deep - Perl module
perl-Test-Deep-Fuzzy - fuzzy number comparison with Test::Deep
perl-Test-Deep-JSON - Perl module to compare JSON with Test::Deep
perl-Test-Differences - Test strings and data structures and show differences if not ok
perl-Test-DistManifest - Author test that validates a package MANIFEST
perl-Test-Distribution - Test::Distribution - perform tests on all modules of a distribution
perl-Test-Dynamic - Advanced automatic test counting for Test::More
perl-Test-EOL - Check the correct line endings in your project
perl-Test-Easy - Testing made absolute easy.
perl-Test-Email - Test Email Contents
perl-Test-Exception - Test exception based code
perl-Test-Exit - Test whether code exits without terminating testing.
perl-Test-Expect - Test::Expect - Automated driving and testing of terminal-based programs
perl-Test-FailWarnings - Add test failures if warnings are caught
perl-Test-Fatal - Simple helpers for testing code with exceptions
perl-Test-File - Perl module to test file attributes
perl-Test-File-ShareDir - Create a Fake ShareDir for your modules for testing
perl-Test-Filename - Perl module for portable filename comparison
perl-Test-Fixture-DBIC-Schema - Load fixture data to storage
perl-Test-Fork - test code which forks
perl-Test-HTTP - Testing for HTTP services
perl-Test-HTTP-Server-Simple - Test::More functions for HTTP::Server::Simple
perl-Test-HTTP-Server-Simple-StashWarnings - catch your forked server's warnings
perl-Test-HasVersion - Check Perl modules have version numbers
perl-Test-HexString - Test::HexString test binary strings with hex dump diagnostics
perl-Test-Identity - Assert the referential identity of a reference
perl-Test-InDistDir - Test environment setup for development with IDE
perl-Test-Inline - Test-Inline - Inlining your tests next to the code being tested
perl-Test-Inter - Framework for more readable interactive test scripts
perl-Test-Kit - Build custom test packages with only the features you want.
perl-Test-Kwalitee - Test the Kwalitee of a distribution before you release it
perl-Test-LectroTest - Perl module for easy, automatic, specification-based tests
perl-Test-Lib - Use libraries from a t/lib directory
perl-Test-LongString - Test-LongString - tests strings for equality, with more helpful failures
perl-Test-Manifest - Interact with a t/test_manifest file
perl-Test-Memory-Cycle - A thin Test::More-compatible wrapper around Devel::Cycle module
perl-Test-MemoryGrowth - assert that code does not cause growth in memory usage
perl-Test-Metrics-Any - assert that code produces metrics via L<Metrics::Any>
perl-Test-MinimumVersion - Check whether your code requires a newer perl
perl-Test-MinimumVersion-Fast - Perl module to check minimal Perl version
perl-Test-Mock-Guard - Simple mock test library using RAII.
perl-Test-Mock-Time - Deterministic time & timers for event loop tests
perl-Test-MockModule - Override subroutines in a module for unit testing
perl-Test-MockObject - Perl extension for emulating troublesome interfaces
perl-Test-MockTime - Replaces actual time with simulated time
perl-Test-Mojibake - Check your source for encoding misbehavior
perl-Test-Moose-More - more tools for testing Moose packages
perl-Test-More-UTF8 - Enhancing Test::More for UTF8-based projects
perl-Test-Most - Test::Most - Most commonly needed test functions and features
perl-Test-Needs - Skip tests when modules not available
perl-Test-NiceDump - let's have a nice and human readable dump of our objects!
perl-Test-NoBreakpoints - Test that files do not contain soft breakpoints
perl-Test-NoTabs - Check the presence of tabs in your project
perl-Test-NoWarnings - Make sure you didn't emit any warnings while testing
perl-Test-Number-Delta - Compare the difference between numbers against a given tolerance
perl-Test-Object - Thoroughly testing objects via registered handlers
perl-Test-Output - Utilities to test STDOUT and STDERR messages
perl-Test-POE-Server-TCP - A POE Component providing TCP server services for test cases
perl-Test-Perl-Critic - Test::Perl::Critic - Use Perl::Critic in test programs
perl-Test-PerlTidy - Perl module to check that all project files are tidy
perl-Test-Pod - Check for POD errors in files
perl-Test-Pod-Content - Test a Pod's content
perl-Test-Pod-Coverage - Test-Pod-Coverage - Check for pod coverage in your distribution
perl-Test-Pod-LinkCheck - Tests POD for invalid links
perl-Test-Portability-Files - Check file names portability
perl-Test-Prereq - Check if Makefile.PL has the right pre-requisites
perl-Test-Refcount - Assert reference counts on objects
perl-Test-Reporter - Sends test results to cpan-testers@perl.org
perl-Test-Requires - Checks to see if the module can be loaded
perl-Test-Requires-Git - Check your test requirements against the available version of Git
perl-Test-RequiresInternet - Easily test network connectivity
perl-Test-Resub - Lexically scoped monkey patching for testing
perl-Test-Run - Named sprintf according to the
perl-Test-Run-CmdLine - Command line front-end for Test-Run
perl-Test-Script - Test::Script - Basic cross-platform tests for scripts
perl-Test-Script-Run - Test the script with run
perl-Test-SharedFork - Test::SharedFork - fork test
perl-Test-Spec - Write tests in a declarative specification style
perl-Test-Spelling - check for spelling errors in POD files
perl-Test-Stream - Comming soon
perl-Test-Strict - Check syntax, presence of use strict; and test coverage
perl-Test-SubCalls - Track the number of times subs are called
perl-Test-Synopsis - Test your SYNOPSIS code
perl-Test-TCP - Test::TCP - testing TCP program
perl-Test-TableDriven - write tests, not scripts that run them
perl-Test-TempDir-Tiny - Perl module to keep test directories if tests fail
perl-Test-Time - Overrides the time() and sleep() core functions for testing
perl-Test-Timer - a test module to test/assert response times
perl-Test-TinyMocker - a very simple tool to mock external modules
perl-Test-Toolbox - Test::Toolbox - tools for testing
perl-Test-TrailingSpace - test for trailing space in source files
perl-Test-Trap - Test::Trap perl module
perl-Test-UseAllModules - Do use_ok() for all the MANIFESTed modules
perl-Test-Valgrind - Generate suppressions, analyze and test any command with valgrind
perl-Test-Vars - Detects unused variables
perl-Test-Version - Check to see that versions in modules are sane
perl-Test-WWW-Mechanize - Test-WWW-Mechanize - Testing-specific WWW::Mechanize subclass
perl-Test-WWW-Mechanize-Catalyst - Test::WWW::Mechanize for Catalyst
perl-Test-WWW-Mechanize-PSGI - Test PSGI programs using WWW::Mechanize
perl-Test-Warn - Perl extension to test methods for warnings
perl-Test-Warnings - Test for warnings and the lack of them
perl-Test-Weaken - Test that freed memory is, in fact, freed
perl-Test-Without-Module - Test fallback behavior in absence of modules
perl-Test-YAML - Testing Module for YAML Implementations
perl-Test-YAML-scripts - Test-YAML scripts
perl-Test-YAML-Meta - Validation of the META.yml file in a distribution
perl-Test-YAML-Valid - Lets you test the validity of YAML files in unit tests
perl-Test-utf8 - Handy utf8 tests
perl-Test2-Plugin-NoWarnings - Fail if tests warn
perl-Test2-Suite - Distribution with a rich set of tools built upon the Test2 framework.
perl-Text-Affixes - Prefixes and suffixes analisys of text
perl-Text-Aligner - align output with given style
perl-Text-Autoformat - Automatic text wrapping and reformatting
perl-Text-Balanced - Extract delimited text sequences from strings
perl-Text-Bidi-scripts - perl-Text-Bidi scripts
perl-Text-Brew - Implementation of the Brew edit distance
perl-Text-CSV - Text::CSV - comma-separated values manipulation routines
perl-Text-CSV-Slurp - Convert CSV into an array of hashes, or an array of hashes into CSV
perl-Text-Clip - Clip and extract text in clipboard-like way
perl-Text-DelimMatch - find regexp delimited strings with proper nesting
perl-Text-Diff - Perform diffs on files and record sets
perl-Text-English - Pod indexer, Porter's stemming algorithm
perl-Text-FindIndent - Text::FindIndent - Heuristically determine the indent style
perl-Text-Format - Various subroutines to format text
perl-Text-FormatTable - Format text tables
perl-Text-German - German grundform reduction
perl-Text-Glob - match globbing patterns against text
perl-Text-Haml - Haml Perl implementation
perl-Text-Markdown - a text-to-HTML filter
perl-Text-MicroTemplate - Micro template engine with Perl5 language
perl-Text-MicroTemplate-Extended - Extended MicroTemplate
perl-Text-MultiMarkdown - Convert MultiMarkdown syntax to (X)HTML
perl-Text-NSP - The Ngram Statistic Package allows a user to count sequences of words in large corpora of text, and measure their association
perl-Text-PDF - PDF Manipulation and generation
perl-Text-Password-Pronounceable - Generate pronounceable passwords
perl-Text-Patch - Patches text with given patch
perl-Text-Quoted - Text-Quoted - Extract the structure of a quoted mail message
perl-Text-RecordParser - Text::RecordParser - read record-oriented files
perl-Text-Reform - Manual text wrapping and reformatting
perl-Text-Roman - Allows conversion between Roman and Arabic algarisms
perl-Text-SimpleTable - Text::SimpleTable - Simple Eyecandy ASCII Tables
perl-Text-Sprintf-Named - Sprintf-like function with named conversions
perl-Text-Table - organize data in tables
perl-Text-TabularDisplay - Text::TabularDisplay - display text in formatted table output
perl-Text-Template - Expand template text with embedded Perl
perl-Text-TestBase - Parser for Test::Base format
perl-Text-Trac - Perl extension for formatting text with Trac Wiki Style
perl-Text-Trac-scripts - perl-Text-Trac scripts
perl-Text-Unidecode - US-ASCII transliterations of Unicode text
perl-Text-WagnerFischer - Text::WagnerFischer is an implementation of the Wagner-Fischer edit distance in Perl.
perl-Text-WikiFormat - Module for translating Wiki formatted text into other formats
perl-Text-Wrap-Smart - Wrap text into chunks of (mostly) equal length
perl-Text-WrapI18N - Line wrapping module with support for multibyte, fullwidth,
perl-Text-Wrapper - Text-Wrapper - Simple word wrapping routine
perl-Text-Xslate-Bridge-TT2Like - Text::Xslate::Bridge::TT2Like - TT2 Variable Method Clone For Text::Xslate
perl-Text-vCard - Module for parsing and creating vCards (RFC 2426) address
perl-Text-vFile-asData - Text-vFile-asData - Perl module
perl-TheSchwartz - TheSchwartz is a reliable job queue system
perl-Throwable - Perl role for classes that are meant to be thrown as exceptions
perl-Tie-Array-QueueExpire - Tie::Array::QueueExpire - tie ARRAY over a TokyoCabinet::BDB database with expiration function
perl-Tie-CPHash - Tie::CPHash - Case preserving but case insensitive hash table
perl-Tie-Cycle - Cycle through a list of values via a scalar
perl-Tie-DBI - Tie Perl hashes to DBI relational databases
perl-Tie-EncryptedHash - Tie-EncryptedHash - Perl module
perl-Tie-File - Access the lines of a disk file via a Perl array
perl-Tie-Filehandle-Preempt-Stdin - Preempt STDIN during testing
perl-Tie-Function - Wrap functions in tied hash sugar
perl-Tie-Handle-Offset - Tied handle that hides the beginning of a file
perl-Tie-IxHash - Ordered associative arrays for Perl
perl-Tie-ListKeyedHash - Tie-ListKeyedHash - Perl module
perl-Tie-RefHash - Use references as hash keys
perl-Tie-RefHash-Weak - Tie::RefHash subclass with weakened references in the keys
perl-Tie-Simple - Variable ties made easier
perl-Tie-Sub - Tie::Sub - Tying a subroutine, function or method to a hash
perl-Tie-ToObject - Tie::ToObject - Tie to an existing object
perl-Time-Duration - rounded or exact English expression of durations
perl-Time-Duration-Parse - Parse string that represents time duration
perl-Time-Format - Easy-to-use date/time formatting
perl-Time-ParseDate - Parse and format time values
perl-TimeDate - Date and time manipulation routines for Perl
perl-Tk-HistEntry - Entry widget with history capability
perl-Tk-MListbox - perl module Tk-MListbox
perl-Tk-Pod - Perl/Tk Pod browser
perl-Tk-Splash - A perl/Tk module for creating splash screens
perl-TokyoCabinet-doc - Documentation for Perl binding to the Tokyo Cabinet
perl-TokyoTyrant - Pure Perl Interface of Tokyo Tyrant
perl-Tree-DAG_Node - (super)class for representing nodes in a tree
perl-Tree-Parser - perl module Tree-Parser
perl-Tree-Simple - Tree-Simple - A simple tree object
perl-Tree-Simple-VisitorFactory - Tree::Simple::VisitorFactory - A factory object for dispensing Visitor objects
perl-Try-Tiny - Minimal try/catch with proper localization of $@
perl-Type-Tie - tie a variable to a type constraint
perl-Type-Tiny - tiny, yet Moo(se)-compatible type constraint
perl-Types-Path-Tiny - Path::Tiny types and coercions for Moose and Mo
perl-Types-Serialiser - simple data types for common serialisation formats
perl-UI-Dialog - OOPerl wrapper for the various dialog applications
perl-UML-Class-Simple - Render simple UML class diagrams, by loading the code
perl-UNIVERSAL-can - Perl module UNIVERSAL::can
perl-UNIVERSAL-isa - Perl module UNIVERSAL::isa
perl-UNIVERSAL-moniker - Guess how class would be called in real world
perl-UNIVERSAL-require - require() modules from a variable
perl-URI - A Perl interface for URI objects
perl-URI-Encode - Perl module for simple percent Encoding/Decoding
perl-URI-Fetch - Smart URI fetching/caching
perl-URI-Find - URI::Find - Find URIs in arbitrary text
perl-URI-FromHash - Build a URI from a set of named parameters
perl-URI-Nested - Perl support for nested URIs
perl-URI-Simple - Simple way to parse uri
perl-URI-Template-Restrict - restricted URI Templates handler
perl-URI-UTF8-Punycode-scripts - perl-URI-UTF8-Punycode scripts
perl-URI-cpan - perl module URI-cpan
perl-URI-db - Perl support for database URIs
perl-URL-Encode - Encoding and decoding of C<application/x-www-form-urlencoded> encoding.
perl-UUID-Tiny - Pure Perl UUID Support With Functional Interface
perl-UUID-URandom - UUIDs based on /dev/urandom or the Windows Crypto API
perl-Unicode-EastAsianWidth - East Asian Width properties
perl-Unicode-IMAPUtf7 - Perl extension to deal with IMAP UTF7
perl-Unicode-Map-scripts - perl-Unicode-Map scripts
perl-Unicode-MapUTF8 - Unicode-MapUTF8 - Perl module
perl-Unicode-Stringprep - Perl module for preparation of Internationalized Strings
perl-Unicode-UTF8simple - Conversions to/from UTF8 from/to charactersets
perl-Unix-Process - perl module Unix-Process
perl-User-Identity - Define a user
perl-VCG - Interface to the VCG graphing tool
perl-VM-EC2 - Control the Amazon EC2 and Eucalyptus Clouds
perl-VM-EC2-scripts - VM-EC2 scripts
perl-VM-EC2-Security-CredentialCache - Cache credentials respecting expriation time for IAM roles.
perl-Validation-Class - Centralized Data Validation Framework
perl-Version-Next - Perl module to increment module version numbers
perl-Version-Requirements - A set of version requirements for a CPAN dist
perl-WWW-Blog-Identify - WWW::Blog::Identify - Identify blogging tools based on URL and content
perl-WWW-Contact - WWW-Contact - Perl module
perl-WWW-Google-PageRank - Perl module to query google pagerank of page
perl-WWW-Mechanize - Handy web browsing in a Perl object
perl-WWW-Pastebin-PastebinCom-Create - Paste to http://pastebin.com from Perl
perl-WWW-RobotRules - Database of robots.txt-derived permissions
perl-WWW-Yandex-TIC - WWW::Yandex::TIC - Query Yandex Thematic Index of Citing (TIC) for domain
perl-Weather-Com - Perl module for accessing weather information
perl-Web-Scraper - Web Scraping Toolkit using HTML and CSS Selectors or XPath expressions
perl-WebService-Gyazo-B - a Perl image upload library for gyazo.com
perl-WebService-MusicBrainz - Web service API to MusicBrainz database
perl-WebService-Prowl - a interface to Prowl Public API
perl-WordNet-QueryData - Perl interface to the WordNet database
perl-WordPress-API - perl module WordPress-API
perl-WordPress-Base-MediaObject - create structs to upload media to wordpress
perl-WordPress-CLI - command line access to wordpress
perl-WordPress-Post - DEPRECATED see WordPress::CLI instead
perl-WordPress-Post-scripts - WordPress-Post scripts
perl-WordPress-XMLRPC - api to wordpress xml rpc calls
perl-Wx-Perl-ProcessStream - Wx::Perl::ProcessStream - access IO of external processes via events
perl-X10 - X10 - Perl extension for X10 'ActiveHome' Controller
perl-X11-Protocol - Raw interface to X Window System servers
perl-X11-Protocol-Other - This is some miscellaneous extras and helpers for X11::Protocol
perl-XML-Atom - Atom API and Feed Support
perl-XML-AutoWriter - provides DTD based XML output
perl-XML-Catalog - Resolve public identifiers and remap system identifiers
perl-XML-Compile - Compilation based XML processing
perl-XML-Compile-Cache - Cache compiled XML translators
perl-XML-Compile-Dumper - Remember precompiled XML processors
perl-XML-Compile-Tester - support XML::Compile related regression testing
perl-XML-DOM - A module for building DOM Level 1 compliant document structures
perl-XML-Descent - XML-Descent - Perl module
perl-XML-Dumper - Perl module for dumping Perl objects from/to XML
perl-XML-Encoding - Module for parsing XML encoding maps
perl-XML-Entities - XML::Entities - Decode strings with XML entities
perl-XML-Entities-scripts - perl-XML-Entities scripts
perl-XML-Feed - XML Syndication Feed Support
perl-XML-Filter-BufferText - SAX Filter to guarantee characters in one event
perl-XML-Generator - Perl extension for generating XML
perl-XML-Grove - Simple access to infoset of parsed XML, HTML, or SGML instances
perl-XML-LibXML-PrettyPrint - Add pleasant white space to an XML tree
perl-XML-LibXML-Simple - XML::LibXML based XML::Simple clone
perl-XML-NamespaceSupport - A simple generic namespace support class
perl-XML-Parser-Lite - Lightweight regexp-based XML parser
perl-XML-Parser-Lite-Tree - Lightweight XML tree builder
perl-XML-RSS - Creates and updates RSS files
perl-XML-RSS-SimpleGen - for writing RSS files
perl-XML-RegExp - Regular expressions for XML tokens
perl-XML-SAX - Simple API for XML
perl-XML-SAX-Base - Base class for SAX Drivers and Filters
perl-XML-SAX-Writer - SAX2 XML Writer
perl-XML-SemanticDiff - Perl extension for comparing XML documents
perl-XML-Simple - Easy API to read/write XML
perl-XML-SimpleObject - A simple object representation of a parsed XML::Parser tree
perl-XML-SimpleObject-LibXML - perl module XML-SimpleObject-LibXML
perl-XML-Stream - XML Stream connection and data parser Perl modules
perl-XML-Tidy - Perl module for tidy indenting of XML documents
perl-XML-TokeParser - Simplified interface to XML::Parser
perl-XML-TreeBuilder - Parser that builds a tree of XML::Element objects
perl-XML-TreePP - Pure Perl implementation for parsing/writing XML documents
perl-XML-Twig - A perl module for processing huge XML documents in tree mode
perl-XML-Writer - Simple Perl module for writing XML documents
perl-XML-Writer-String - Capture output from XML::Writer
perl-XML-XPath - A set of modules for parsing and evaluating XPath statements
perl-XML-XPathEngine - Re-usable XPath engine for DOM-like trees
perl-XML-XQL - A perl module for querying XML tree structures with XQL
perl-XML-XQL-scripts - perl-XML-XQL scripts
perl-XML-XSPF - API for reading & writing XSPF Playlists
perl-XMLRPC-Lite - client and server implementation of XML-RPC protocol
perl-XXX - See Your Data in the Nude
perl-YAML - YAML Ain't Markup Language
perl-YAML-PP - YAML Parser and Loader
perl-YAML-PP-scripts - YAML-PP scripts
perl-YAML-PP-LibYAML - Faster backend for YAML::PP
perl-YAML-Tiny - Read/Write YAML files with as little code as possible
perl-Zabbix-Sender - A pure-perl implementation of zabbix-sender
perl-accessors - Create accessor methods in caller's package
perl-ack - A grep-like program specifically for large source trees
perl-aliased - Use shorter versions of class names
perl-asterisk-perl - Asterisk Perl Interface
perl-autobox-Core - Perl module with core functions to autoboxed scalars, arrays and hashes
perl-autobox-Junctions - Perl module for autoboxified junction-style operators
perl-autodie - Replace functions with ones that succeed or die with lexical scope
perl-bignum - Transparent BigNumber support for Perl
perl-boolean - Boolean support for Perl
perl-capitalization - capitalization - no capitalization on method names
perl-constant-defer - Constant subs with deferred value calculation
perl-curry - Create automatic curried method call closures for any class or object
perl-experimental - Experimental features made easy
perl-iec104 - Perl implementation of IEC 60870-5-104 standard (server and client)
perl-inc-latest - use modules bundled in inc/ if they are newer than installed ones
perl-junoscript - Perl modules for manage JunOS routers from Perl scripts
perl-junoscript-examples - examples of using perl-junoscript
perl-ldap - perl-ldap - A Client interface to LDAP servers
perl-ldap-contrib - perl-ldap - some useful progs for work with ldap thru perl
perl-lib-abs - Module lib that makes relative path absolute to caller
perl-lib-relative - Add paths relative to the current file to @INC
perl-libnet - Collection of Network protocol modules for Perl
perl-libwww - WWW client/server library for Perl (aka LWP)
perl-libxml-perl - Collection of Perl modules for working with XML
perl-local-lib - Create and use a local lib/ for perl modules with PERL5LIB
perl-mime-construct - Construct/send MIME messages from the command line
perl-namespace-autoclean - Keep imports out of your namespace
perl-namespace-clean - Keep imports and functions out of your namespace
perl-parent - Establish an ISA relationship with base classes at compile time
perl-pip - The Perl Installation Program, for scripted and third-party distribution installation
perl-pod2pdf - Converts Pod to PDF format
perl-podlators - Convert POD data to various other formats
perl-podlinkcheck - Check Perl POD L<> link references
perl-prefork - Pragma to ensure modules are fully loaded before forking
perl-provide - easily choose between different version-specific implementations
perl-recommended - Perl module to load recommended modules on demand
perl-rlib - Manipulate @INC at compile time with relative paths
perl-strictures - strictures - turn on strict and make all warnings fatal
perl-syntax - Activate syntax extensions
perl-utf8-all - Turn on Unicode everywhere
perl-Repocop-Report-Tools - shared library for repocop report scripts
perl-RT-Test - rt's test utility module
perl-Mail-SpamAssassin - Mail::SpamAssassin - SpamAssassin e-mail filter libraries
perl-X2Go-Log - Perl X2Go::Log package
perl-X2Go-Server - Perl X2Go::Server package
