perl-Sys-Guestfs - Perl bindings for libguestfs (Sys::Guestfs)
perl-B-COW - B::COW additional B helpers to check COW status
perl-B-Flags - B::Flags - Friendlier flags for B
perl-Boost-Geometry-Utils - Boost::Geometry::Utils Perl module
perl-Class-C3-XS - XS speedups for Class::C3
perl-Class-Load-XS - XS implementation of parts of Class::Load
perl-Cookie-Baker-XS - boost Cookie::Baker's crush_cookie
perl-Cpanel-JSON-XS - JSON::XS for Cpanel, fast and correct serialising, also for 5.6.2
perl-Crypt-DH-GMP - Crypt::DH Using GMP Directly
perl-Crypt-Rijndael - Crypt::CBC compliant Rijndael encryption module
perl-DBI-Gofer - DBI::Gofer proxy server classes
perl-DBI-ProxyServer - A server for the DBD::Proxy driver
perl-Date-Calc-XS - XS wrapper and C library plug-in for Date::Calc
perl-Device-SerialPort - Linux/POSIX emulation of Win32::SerialPort functions
perl-Digest-CRC - Digest::CRC - Generic CRC functions
perl-IO-Interface - extention for IO::Socket
perl-JavaScript-V8 - JavaScript::V8 - Perl interface to the V8 JavaScript engine
perl-List-MoreUtils-XS - Provide compiled List::MoreUtils functions
perl-Math-BigInt-GMP - Use the GMP library for Math::BigInt routines
perl-Math-BigInteger - Math::BigInteger - arbitrary length integer extension module for Perl
perl-POSIX-1003 - POSIX::1003, alternative for POSIX in core
perl-Package-Stash-XS - Faster and more correct implementation of the Package::Stash API
perl-PerlX-Maybe-XS - XS backend for PerlX::Maybe
perl-Ref-Util-XS - XS implementation for Ref::Util Perl module
perl-Module-Build-SDL - Module::Build subclass for building SDL apps/games
perl-Text-Xslate - Text::Xslate - Scalable template engine for Perl5
perl-Time-Format_XS - Companion module for Time::Format, to speed up time formatting
perl-Tk-TableMatrix - The Tk::TableMatrix Widget
perl-Tk-TableMatrix-devel - The Tk::TableMatrix Widget
perl-URI-Escape-XS - Drop-In replacement for URI::Escape
perl-URL-Encode-XS - XS implementation of URL::Encode
perl-Wx-Scintilla - Wx::Scintilla - Scintilla source code editing component for wxWidgets
perl-X2Go-Server-DB - Perl X2Go::Server::DB package
i586-perl-B-COW - B::COW additional B helpers to check COW status
i586-perl-B-Flags - B::Flags - Friendlier flags for B
i586-perl-Boost-Geometry-Utils - Boost::Geometry::Utils Perl module
i586-perl-Class-C3-XS - XS speedups for Class::C3
i586-perl-Class-Load-XS - XS implementation of parts of Class::Load
i586-perl-Cookie-Baker-XS - boost Cookie::Baker's crush_cookie
i586-perl-Cpanel-JSON-XS - JSON::XS for Cpanel, fast and correct serialising, also for 5.6.2
i586-perl-Crypt-DH-GMP - Crypt::DH Using GMP Directly
i586-perl-Crypt-Rijndael - Crypt::CBC compliant Rijndael encryption module
i586-perl-Date-Calc-XS - XS wrapper and C library plug-in for Date::Calc
i586-perl-Device-SerialPort - Linux/POSIX emulation of Win32::SerialPort functions
i586-perl-Digest-CRC - Digest::CRC - Generic CRC functions
i586-perl-IO-Interface - extention for IO::Socket
i586-perl-JavaScript-V8 - JavaScript::V8 - Perl interface to the V8 JavaScript engine
i586-perl-List-MoreUtils-XS - Provide compiled List::MoreUtils functions
i586-perl-Math-BigInt-GMP - Use the GMP library for Math::BigInt routines
i586-perl-Math-BigInteger - Math::BigInteger - arbitrary length integer extension module for Perl
i586-perl-POSIX-1003 - POSIX::1003, alternative for POSIX in core
i586-perl-Package-Stash-XS - Faster and more correct implementation of the Package::Stash API
i586-perl-PerlX-Maybe-XS - XS backend for PerlX::Maybe
i586-perl-Ref-Util-XS - XS implementation for Ref::Util Perl module
i586-perl-Sys-Guestfs - Perl bindings for libguestfs (Sys::Guestfs)
i586-perl-Text-Xslate - Text::Xslate - Scalable template engine for Perl5
i586-perl-Time-Format_XS - Companion module for Time::Format, to speed up time formatting
i586-perl-Tk-TableMatrix - The Tk::TableMatrix Widget
i586-perl-URI-Escape-XS - Drop-In replacement for URI::Escape
i586-perl-URL-Encode-XS - XS implementation of URL::Encode
i586-perl-Wx-Scintilla - Wx::Scintilla - Scintilla source code editing component for wxWidgets
perl-RPM-Specfile-Multispec - RPM::Specfile::Multispec - Perl extension for creating RPM Specfiles
perl-Algorithm-C3 - Algorithm::C3 - A module for merging hierarchies using the C3 algorithm
perl-Alien-Base-ModuleBuild - Perl framework for building Alien:: modules and their libraries
perl-Alien-Role-Alt - Alien::Base role that supports alternates
perl-Amon2-Lite - Amon2::Lite - Sinatra-ish framework on Amon2
perl-AnyEvent-Gearman - AnyEvent::Gearman - Asynchronous Gearman client/worker module for AnyEvent applications
perl-AnyEvent-HTTP - AnyEvent::HTTP - simple but non-blocking HTTP/HTTPS client
perl-AnyEvent-HTTP-LWP-UserAgent - Perl module AnyEvent::HTTP::LWP::UserAgent
perl-AnyEvent-SNMP - Perl adaptor to integrate Net::SNMP into AnyEvent
perl-Apache2-SOAP - A replacement for Apache::SOAP designed to work with mod_perl 2
perl-App-Rad - Extend the App::Rad framework!
perl-App-cpanminus - App::cpanminus - get, unpack, build and install modules from CPAN
perl-Array-Compare - Array::Compare - perl module comparing arrays
perl-Array-Iterator - A subclass of Array::Iterator to allow forwards and backwards iteration
perl-Array-Unique - Array::Unique - Tie-able array that allows only unique values
perl-Astro-SunTime - Astro::SunTime provides a function interface to calculate sun rise/set times.
perl-B-Debug - B::Debug - Walk Perl syntax tree, printing debug info about ops
perl-Business-ISBN-Data - data pack for Business::ISBN
perl-CGI-Ajax - CGI::Ajax - a perl-specific system for writing Asynchronous web applications
perl-CGI-Apache - CGI::Apache - Backward compatibility module for CGI.pm
perl-CGI-Compile - CGI::Compile - Compile .cgi scripts to a code reference like ModPerl::Registry
perl-CGI-Emulate-PSGI - CGI::Emulate::PSGI - PSGI adapter for CGI
perl-CGI-Ex-samples - sample files for CGI::Ex
perl-CGI-Fast - CGI::Fast is a subclass of the CGI object created by CGI.pm
perl-CLI-Osprey - MooX::Options + MooX::Cmd + Sanity
perl-CPAN-Checksums - CPAN::Checksums - Write a "CHECKSUMS" file for a directory as on CPAN
perl-CPAN-Inject - CPAN::Inject - Base class for injecting distributions into CPAN sources
perl-Parse-CPAN-Meta - Parse::CPAN::Meta - Parse META.yml and META.json CPAN metadata files
perl-CPAN-Meta-Check - Verify requirements in a CPAN::Meta object
perl-Capture-Tiny - Capture::Tiny - Capture STDOUT and STDERR from Perl, XS or external programs
perl-Carp-Assert-More - Carp-Assert-More - convenience wrappers around Carp::Assert
perl-Catalyst-Action-RenderView - Catalyst::Action::RenderView - Sensible default end action
perl-Catalyst-Controller-HTML-FormFu - HTML::FormFu controller for Catalyst
perl-Catalyst-Model-DBIC-Schema - DBIx::Class::Schema Model Class
perl-Catalyst-Plugin-Authorization-Roles - Catalyst::Plugin::Authorization::Roles - Role based authorization for Catalyst
perl-Catalyst-Plugin-ConfigLoader - Catalyst::Plugin::ConfigLoader - Load config files of various types
perl-Catalyst-Plugin-FormValidator - Catalyst::Plugin::FormValidator - FormValidator for Catalyst
perl-Catalyst-Plugin-Session - Catalyst::Plugin::Session - Generic Session plugin - ties together server side
perl-Catalyst-Plugin-Session-State-Cookie - Catalyst::Plugin::Session::State::Cookie - Maintain session IDs using cookies
perl-Catalyst-Plugin-Static-Simple - Catalyst::Plugin::Static::Simple - Make serving static pages painless
perl-Catalyst-View-HTML-Mason - Helper for L<Catalyst::View::HTML::Mason> views
perl-Catalyst-View-TT - Catalyst::View::TT - Template View Class
perl-Catalyst-View-TT-Alloy - Template::Alloy (TT) View Class
perl-Check-ISA - Check::ISA perl module
perl-Class-Accessor-Chained - Class::Accessor::Chained - make chained accessors
perl-Class-Accessor-Lite - Class::Accessor::Lite - a minimalistic variant of Class::Accessor
perl-Class-Adapter - Class::Adapter - Perl implementation of the "Adapter" Design Pattern
perl-Class-Base - Class::Base - useful base class for deriving other modules
perl-Class-CGI - Class::CGI - fetch objects from your CGI object
perl-Class-DBI-Pg - Class::DBI extension for PostgreSQL
perl-Class-DBI-SQLite - Extension to Class::DBI for SQLite
perl-Class-Data-Accessor - Class::Data::Accessor - Inheritable, overridable class and instance data accessor creation
perl-Class-InsideOut - Class::InsideOut - safe, simple inside-out object construction kit
perl-Class-Iterator - Class::Iterator - generic iterator object class
perl-Class-Load - A working (require "Class::Name") and more
perl-Class-Std-Fast - Perl module that provides a faster but less secure version of Class::Std
perl-Code-TidyAll - Test::Code::TidyAll - Check that all your files are tidy and valid according to tidyall
perl-Config-YAML - Perl module Config::YAML - simple configuration automation
perl-Convert-Bencode - Convert::Bencode - Functions for converting to/from bencoded strings
perl-Crypt-SaltedHash - Crypt::SaltedHash - Perl interface to functions that assist in working with salted hashes
perl-DBICx-TestDatabase - Create a temporary database from a DBIx::Class::Schema
perl-DBIx-Class-DeploymentHandler - Extensible DBIx::Class deployment
perl-DBIx-Class-InflateColumn-Object-Enum - Allows a DBIx::Class user to define a Object::Enum column
perl-DBIx-Class-OptimisticLocking - Optimistic locking support for DBIx::Class
perl-DBIx-Class-Schema-Config - Credential Management for DBIx::Class
perl-DBIx-Class-Schema-Loader - Dynamic definition of a DBIx::Class::Schema
perl-DBIx-Class-SingletonRows - make database rows returned by DBIx::Class
perl-DBIx-Class-TimeStamp - DBIx::Class extension to update and create date and time based fields
perl-DBIx-Class-Tutorial - DBIx::Class::Tutorial - tutorial for DBIx::Class
perl-DBIx-Class-WebForm - DBIx::Class::WebForm - CRUD Methods For DBIx::Class
perl-Dancer-Plugin-Database - Dancer::Plugin::Database - easy database connections for Dancer applications
perl-Dancer-Template-Xslate - Dancer::Template::Xslate - Text::Xslate wrapper for Dancer
perl-Data-Denter - An alternative to Data::Dumper and Storable
perl-Data-FormValidator - Data::FormValidator - Validates user input (usually from an HTML form) based on input profile
perl-Data-Localize - Data::Localize perl module
perl-Data-Page - Data::Page - help when paging through sets of results
perl-Data-Section-Simple - Data::Section::Simple - Read data from __DATA__
perl-Data-Serializer - Data::Serializer - Modules that serialize data structures
perl-Data-TreeDumper-Renderer-GTK - Rendering plug-in for Data::TreeDumper
perl-Data-Visitor - Data::Visitor - Visitor style traversal of Perl data structures
perl-DateTime-Event-Recurrence - DateTime::Set extension for create basic recurrence sets
perl-DateTime-Format-Builder - DateTime::Format::Builder - create DateTime parser classes and objects
perl-DateTime-Format-DateManip - Convert Date::Manip to DateTime and vice versa
perl-DateTime-Format-DateParse - Parses Date::Parse compatible formats
perl-DateTime-Format-HTTP - DateTime::Format::HTTP - Date conversion routines
perl-Devel-Cycle - Devel::Cycle - Find memory cycles in objects
perl-Devel-DProfPP - Devel::DProfPP - Parse Devel::DProf output
perl-Devel-Dumpvar - Devel::Dumpvar - A pure-OO reimplementation of dumpvar.pl
perl-Devel-OverrideGlobalRequire - Override CORE::GLOBAL::require safely
perl-Devel-PatchPerl - Patch perl source a la Devel::PPPort's buildperl.pl
perl-Devel-REPL-Plugin-DDC - Devel-REPL plugin for formatting results with Data::Dumper::Concise
perl-Devel-REPL-Plugin-DDS - Devel-REPL plugin for formatting results with Data::Dump::Streamer
perl-Devel-StackTrace - Devel::StackTrace - An object representing a stack trace
perl-Devel-StackTrace-AsHTML - Devel::StackTrace::AsHTML - Displays stack trace in HTML
perl-Devel-StackTrace-WithLexicals - Devel::StackTrace + PadWalker
perl-Dist-Zilla-Plugin-Bootstrap-lib - a minimal boot-strapping for Dist::Zilla Plug-ins
perl-Dist-Zilla-Plugin-CheckChangesHasContent - Dist::Zilla plugin to ensure Changes has content before releasing
perl-Dist-Zilla-Plugin-CheckExtraTests - Dist::Zilla plugin to check xt tests before release
perl-Dist-Zilla-Plugin-Config-Git - Dist::Zilla plugin configuration for a Git repo
perl-Dist-Zilla-Plugin-DynamicPrereqs - Dist::Zilla plugin to specify dynamic prerequisites for distribution
perl-Dist-Zilla-Plugin-Git-Contributors - Dist::Zilla plugin to add contributor names from git
perl-Dist-Zilla-Plugin-MakeMaker-Awesome - a more awesome MakeMaker plugin for Dist::Zilla
perl-Dist-Zilla-Plugin-OptionalFeature - Dist::Zilla plugin to specify prerequisites for optional features in distribution
perl-Dist-Zilla-Plugin-OurPkgVersion - Dist::Zilla plugin for package version management
perl-Dist-Zilla-Plugin-PodWeaver - weave Pod together from configuration and Dist::Zilla
perl-Dist-Zilla-Plugin-PromptIfStale - Dist::Zilla module to check at build/release time
perl-Dist-Zilla-Plugin-Run - Perl module to run commands at specific phases of Dist::Zilla
perl-Dist-Zilla-Plugin-Test-Perl-Critic - Dist::Zilla tests to check code against best practices
perl-Dist-Zilla-PluginBundle-RJBS - BeLike::RJBS when you build your dists
perl-Dist-Zilla-Role-Bootstrap - Dist::Zilla module with shared logic for bootstrap things
perl-Dist-Zilla-Role-DynamicConfig - Dist::Zilla role that accepts a dynamic configuration
perl-Dist-Zilla-Role-ModuleMetadata - a role for plugins that use Module::Metadata
perl-Dist-Zilla-Role-PluginBundle-PluginRemover - Dist::Zilla plugin to a '-remove' functionality to a bundle
perl-Dist-Zilla-Role-RegisterStash - Dist::Zilla plugin that can register stashes
perl-Dist-Zilla-Role-Stash-Plugins - Dist::Zilla Stash that stores arguments for plugins
perl-Dist-Zilla-Stash-PodWeaver - Dist::Zilla plugin to stash of config options for Pod::Weaver
perl-Dist-Zilla-Util-ConfigDumper - A Dist::Zilla plugin configuration extraction utility
perl-Email-Find - Email::Find - Find RFC 822 email addresses in plain text
perl-Email-Folder - Read all the messages from a folder as Email::Simple objects
perl-Email-FolderType - Email::FolderType - determine the type of a mail folder
perl-Email-Valid-Loose - Email::Valid::Loose - Email::Valid which allows dot before at mark
perl-Event-ExecFlow - Event::ExecFlow - High level API for event-based execution flow control
perl-Excel-Template - creating MS Excel file from HTML::Template data structure
perl-Exception-Class-DBI - Exception::Class::DBI - DBI Exception objects
perl-Exception-Class-TryCatch - Exception::Class::TryCatch - Syntactic try/catch sugar for use with Exception::Class
perl-Exporter-Lite - Exporter::Lite - Lightweight exporting of variables
perl-Exporter-Tidy - Perl module Exporter::Tidy
perl-Exporter-Tiny - an exporter with the features of Sub::Exporter but only core dependencies
perl-ExtUtils-MY_Metafile - META.yml customize with ExtUtil::MakeMaker
perl-FCGI-Client - FCGI::Client - client library for fastcgi protocol
perl-FCGI-ProcManager - FCGI::ProcManager - A perl-based FastCGI process manager
perl-File-Corresponding - File::Corresponding - Find corresponding files in the directory tree
perl-File-Find-Object - an object oriented File::Find replacement
perl-File-Find-Object-Rule - alternative interface to File::Find::Object
perl-File-Find-Rule - Alternative interface to File::Find
perl-File-Finder - wrapper for File::Find module
perl-File-Flat - File::Flat - Implements a flat filesystem
perl-File-Modified - File::Modified - checks intelligently if files have changed
perl-File-Path-Tiny - recursive versions of mkdir() and rmdir() without as much overhead as File::Path
perl-File-Share - Extend File::ShareDir to Local Libraries
perl-File-chmod - File::chmod - Implements symbolic and ls chmod modes
perl-Filesys-Notify-Simple - Filesys::Notify::Simple - Simple and dumb file system watcher
perl-FindBin-libs - FindBin::libs - locate and a 'use lib' or export
perl-FormValidator-Lite - FormValidator::Lite perl module
perl-Format-Human-Bytes - Format::Human::Bytes - Format a bytecount and make it human readable
perl-GD-Graph3d - Create 3D Graphs with GD and GD::Graph
perl-Geo-IP-PurePerl - Geo::IP::PurePerl - Look up country by IP Address
perl-Geo-IPfree - Geo::IPfree - Look up country by IP Address
perl-Getopt-Long-Descriptive - Getopt::Long, but simpler and more powerful
perl-Git-Repository - Git::Repository - Perl interface to Git repositories
perl-GooCanvas2 - Perl binding for GooCanvas2 widget using Glib::Object::Introspection
perl-Graph-ReadWrite - Graph::Reader::Dot - class for reading a Graph instance from Dot format
perl-Gtk2-GladeXML-Simple - A clean object-oriented interface to Gtk2::GladeXML
perl-HTML-Element-Extended - Perl extension for manipulating a table composed of HTML::Element style components
perl-HTML-Entities-Interpolate - Call HTML::Entities::encode_entities via a hash within a string
perl-HTML-FillInForm - HTML::FillInForm - Populates HTML Forms with data
perl-HTML-FillInForm-Lite - HTML::FillInForm::Lite - Fills in HTML forms with data
perl-HTML-FromText - A perl module for HTML::FromText
perl-HTML-Mason-PSGIHandler - PSGI handler for HTML::Mason
perl-HTML-Shakan - HTML::Shakan - form html generator/validator
perl-HTML-StickyQuery - HTML::StickyQuery - add sticky QUERY_STRING
perl-HTML-Template-JIT - A just-in-time compiler for HTML::Template
perl-HTML-Template-Parser - Parser for HTML::Template syntax template file & writer.
perl-HTML-TreeBuilder-LibXML - HTML::TreeBuilder and XPath compatible interface with libxml
perl-HTML-TreeBuilder-XPath - Add XPath support to HTML::TreeBuilder
perl-HTTP-Headers-Fast - Faster implementation of HTTP::Headers
perl-HTTP-Lite - HTTP::Lite - Lightweight HTTP implementation
perl-HTTP-Request-AsCGI - HTTP::Request::AsCGI - Setup a CGI enviroment from a HTTP::Request
perl-HTTP-Server-Simple-Authen - Authentication plugin for HTTP::Server::Simple
perl-HTTP-Server-Simple-PSGI - HTTP::Server::Simple::PSGI - PSGI handler for HTTP::Server::Simple
perl-HTTP-Session - HTTP::Session - simple session
perl-HTTP-Tiny-Multipart - Add post_multipart to HTTP::Tiny
perl-Hash-MoreUtils - Provide the stuff missing in Hash::Util
perl-Hash-MultiValue - Hash::MultiValue - Store multiple values per key
perl-Hash-Util-FieldHash-Compat - Use Hash::Util::FieldHash or ties, depending on availability
perl-IO-AIO-Util - aio_mkpath and aio_mktree functions missing from IO::AIO
perl-IO-All - IO::All of it to Graham and Damian!
perl-Future-IO-Impl-IOAsync - Future::IO Implementation using IO::Async
perl-IO-Capture-Extended - Extend functionality of IO::Capture
perl-IO-Multiplex - IO::Multiplex - Manage IO on many file handles
perl-IO-SessionData - supporting module for SOAP::Lite
perl-IO-Socket-IP - IO::Socket::IP - A drop-in replacement for IO::Socket::INET supporting both IPv4 and IPv6
perl-IO-Socket-Timeout - Perl IO::Socket with read/write timeout
perl-IO-String - IO::File interface emulation for in-core Perl strings
perl-IO-Zlib - IO:: style interface to Compress::Zlib
perl-IPC-Open3-Simple - A simple alternative to IPC::Open3
perl-IPC-Shareable - IPC::Shareable - share Perl variables between processes
perl-Image-Base-Other - Misc other helpers for Image::Base.
perl-JSON-MaybeXS - use L<Cpanel::JSON::XS> with a fallback to L<JSON::PP>
perl-JSON-PP - JSON::XS compatible pure-Perl module
perl-JavaScript-Beautifier - JavaScript::Beautifier - Beautify Javascript (beautifier for javascript)
perl-JavaScript-Minifier - JavaScript::Minifier - Perl extension for minifying JavaScript code
perl-JavaScript-Value-Escape - JavaScript::Value::Escape - Avoid XSS with JavaScript value interpolation
perl-LWP-Online - LWP::Online - Does your process have access to the web
perl-LWP-Protocol-https - Provide https support for LWP::UserAgent
perl-LWPx-ParanoidAgent - subclass of LWP::UserAgent that protects you from harm
perl-Lingua-EN-Inflect-Number - Lingua::EN::Inflect::Number - Force number of words to singular or plural
perl-Lingua-EN-Numbers-Easy - Hash access to Lingua::EN::Numbers objects
perl-Lingua-JA-Regular-Unicode - Lingua::JA::Regular::Unicode - convert japanese chars
perl-Lingua-RU-Antimat - Lingua::RU::Antimat - Perl Module for removal Russian slang from chat, guestbooks, etc.
perl-List-MoreUtils - Provide the stuff missing in List::Util
perl-List-SomeUtils - Provide the stuff missing in List::Util
perl-Locale-Maketext-Lexicon - Locale::Maketext::Lexicon - Use other catalog formats in Maketext
perl-Locale-Maketext-Simple - Simple interface to Locale::Maketext::Lexicon
perl-Log-Any - Log::Any - bringing loggers and listeners together
perl-Log-Any-IfLOG - Load Log::Any only if LOG environment variable is true
perl-Log-Channel - Log::Channel - yet another logging package
perl-Log-Dispatch-Config - Log::Dispatch::Config - Log4j for Perl
perl-Log-Dispatch-Perl - Log::Dispatch::Perl - Use core Perl functions for logging
perl-Log-Dispatchouli - a simple wrapper around Log::Dispatch
perl-Log-Message-Simple - Simplified interface to Log::Message
perl-Log-Report-Optional - Log::Report in the lightest form
perl-Logger-Syslog - A simple wrapper over Sys::Syslog perl module
perl-MIME-Lite-TT - TT enabled MIME::Lite wrapper
perl-MIME-Lite-TT-HTML - Create html mail with MIME::Lite and TT
perl-MRO-Compat - mro::* interface compatibility for Perls < 5.9.5
perl-Mason-Tidy - Tidy HTML::Mason/Mason components
perl-Math-Complex - Math::Complex - complex numbers and associated mathematical functions
perl-Math-Polynomial-Horner - Stringizing Math::Polyomial objects in Horner form.
perl-Math-Symbolic-Custom-Pattern - Pattern matching on Math::Symbolic trees
perl-Math-Symbolic-Custom-Transformation - Transform Math::Symbolic trees
perl-Module-Build-Pluggable - Module::Build meets plugins
perl-Module-Build-Tiny - A tiny replacement for Module::Build
perl-Module-Build-Using-PkgConfig - extend C<Module::Build> to more easily use platform libraries provided by F<pkg-config>
perl-Module-Build-WithXSpp - XS++ enhanced flavor of Module::Build
perl-Module-Build-XSUtil - A Module::Build class for building XS modules
perl-Module-Find - Module::Find - Find and use installed modules in a (sub)category
perl-Module-Implementation - Module::Implementation loads one of several alternate underlying implementations for a module
perl-Module-Install-AuthorTests - Module::Install::AuthorTests designate tests only run by module authors
perl-Module-Install-CheckLib - Module::Install::CheckLib - A Module::Install extension to check that a library is available
perl-Module-Install-ReadmeFromPod - Module::Install extension to automatically convert POD to a README
perl-Module-Install-TestBase - Module Install Support for Test::Base
perl-Module-Install-XSUtil - Module::Install::XSUtil - utility functions for XS modules
perl-Module-Manifest - Module::Manifest - Parse and examine a Perl distribution MANIFEST file
perl-Module-Starter-PBP - Module::Starter::PBP - Create a module as recommended in "Perl Best Practices"
perl-Module-Starter-Plugin-SimpleStore - template storage methods for Module::Starter
perl-Module-Starter-Plugin-TT2 - TT2 templates for Module::Starter::Template
perl-Module-Util - Module::Util - Module name tools and transformations
perl-Mojo-RabbitMQ-Client - Mojo::IOLoop based RabbitMQ client
perl-MojoX-Renderer-Xslate - MojoX::Renderer::Xslate - Text::Xslate renderer for Mojo
perl-Mojolicious-Plugin-I18N - Mojolicious::Plugin::I18N - Internationalization Plugin for Mojolicious
perl-MooX-Role-Parameterized - MooX::Role::Parameterized - roles with composition parameters
perl-MooX-TypeTiny - Optimized type checks for Moo + Type::Tiny
perl-MooseX-App-Cmd - Mashes up MooseX::Getopt and App::Cmd
perl-MooseX-Clone - MooseX::Clone - fine grained cloning support for Moose objects
perl-MooseX-Emulate-Class-Accessor-Fast - Emulate Class::Accessor::Fast behavior using Moose attributes
perl-MooseX-Log-Log4perl - A Logging Role for Moose based on Log::Log4perl
perl-MooseX-Params-Validate - an extension of Params::Validate for using Moose's types
perl-MooseX-TraitFor-Meta-Class-BetterAnonClassNames - metaclass for the MooseX::Util module
perl-MooseX-Types-NetAddr-IP - NetAddr::IP related types and coercions for Moose
perl-MooseX-Types-Path-Class - A Path::Class type library for Moose
perl-MooseX-Types-Path-Tiny - Path::Tiny types and coercions for Moose
perl-MooseX-Util - Perl module with Moose::Util extensions
perl-MouseX-App-Cmd - Mashes up MouseX::Getopt and App::Cmd
perl-MouseX-Foreign - MouseX::Foreign - Extends non-Mouse classes as well as Mouse classes
perl-MouseX-Types-Path-Class - A Path::Class type library for Mouse
perl-Net-Async-CassandraCQL - use Cassandra databases with IO::Async using CQL
perl-Net-DNS - Net::DNS is a DNS resolver implemented in Perl
perl-Net-DNS-Codes - Net::DNS::Codes - collection of C library DNS codes
perl-Net-FastCGI - Net::FastCGI - FastCGI Toolkit
perl-Net-IMAP-Simple-SSL - Perl extension for adding SSL support for NEt::IMAP::Simple
perl-Net-Jabber - Net::Jabber - Jabber Perl Library
perl-Net-LDAP-Server-Test - Test Net::LDAP code
perl-Net-NBsocket - Net::NBsocket - Non-Blocking Sockets
perl-Net-OpenID-Common - Libraries shared between Net::OpenID::Consumer and Net::OpenID::Server
perl-Net-OpenSSH - Net::OpenSSH - Perl SSH client package implemented on top of OpenSSH
perl-Net-Pcap-Easy - Net::Pcap is awesome, but it's difficult to bootstrap
perl-Net-Pcap-Reassemble - IP fragment reassembly for Net::Pcap
perl-Net-SMTP-SSL - SSL support for Net::SMTP
perl-Net-SMTPS - SSL/STARTTLS support for Net::SMTP
perl-Net-SMTP_auth - SMTP_AUTH wrapper for Net::SMTP (rfc2554)
perl-Net-SNMP - Net::SNMP (module for perl) - Object oriented interface to SNMP
perl-Net-Server - Net::Server - Extensible, general Perl server engine
perl-Net-Stomp - Net::Stomp - a Streaming Text Orientated Messaging Protocol Client
perl-Net-TFTP - Net::TFTP - TFTP Client class
perl-Number-Misc - Number::Misc - handy utilities for numbers
perl-ORLite-Migrate - ORLite::Migrate - Extremely light weight SQLite-specific schema
perl-Object-Container - Object::Container - simple object container
perl-Object-Event - Object::Event - A class that provides an event callback interface
perl-Object-Signature - Object::Signature - Generate cryptographic signatures for objects
perl-PDF-API2-Simple - simplistic wrapper for the PDF::API2 modules
perl-PDF-Reuse-Barcode - Create barcodes for PDF documents with PDF::Reuse
perl-POD2-Base - POD2::Base - Base module for translations of Perl documentation
perl-POE-Component-Client-DNS - Non-blocking/concurrent DNS queries using Net::DNS and POE
perl-POE-Filter-Zlib - A POE filter wrapped around Compress::Zlib
perl-POE-Test-Loops - POE::Loop test suite
perl-PPIx-EditorTools - PPIx::EditorTools - Utility methods and base class for manipulating Perl
perl-PPIx-Utilities - PPIx::Utilities - Extensions to PPI.
perl-Perl-Tidy-Sweetened - Tweaks to Perl::Tidy to support some syntactic sugar
perl-Plack-Middleware-FixMissingBodyInRedirect - Plack::Middleware which sets body for redirect response, if it's not already set
perl-Plack-Middleware-RemoveRedundantBody - Plack::Middleware which sets removes body for HTTP response if it's not required
perl-Plack-Middleware-ReverseProxy - Plack::Middleware::ReverseProxy - supports app to run as a reverse proxy backend
perl-Plack-Middleware-Session - Plack::Middleware::Session - Middleware for session management
perl-Pod-Checker - Pod::Checker verifies POD documentation contents for compliance with the POD format specifications
perl-Pod-Coverage-TrustPod - Allow a module's pod to contain Pod::Coverage hints
perl-Pod-POM-View-Restructured - View for Pod::POM that outputs reStructuredText
perl-Pod-Usage - Pod::Usage extracts POD documentation and shows usage information
perl-Proc-Simple - Perl module Proc::Simple
perl-Proc-SyncExec - Perl module Proc::SyncExec
perl-Protocol-WebSocket - Protocol::WebSocket - WebSocket protocol
perl-RPM-Specfile - RPM::Specfile - Perl extension for creating RPM Specfiles
perl-RRDTool-OO - RRDTool::OO - Object-oriented interface to RRDTool
perl-Regexp-Common-WithActions - adds actions to Regexp::Common
perl-Role-Tiny - Role::Tiny - minimalist role composition tool
perl-Router-Simple - Router::Simple perl module
perl-Router-Simple-Sinatraish - Router::Simple::Sinatraish - Sinatra-ish routers on Router::Simple
perl-SMS-Send-DeviceGsm - An SMS::Send driver for Device::Gsm
perl-SOAP-Transport-HTTP-Nginx - transport for nginx (http://nginx.net/) http server for SOAP::Lite module
perl-SQL-Abstract-Limit - SQL::Abstract::Limit - portable LIMIT emulation
perl-SQL-Abstract-Pg - PostgreSQL features for SQL::Abstract
perl-Server-Starter - Server::Starter - a superdaemon for hot-deploying server programs
perl-Set-IntSpan - Set::IntSpan - Manages sets of integers
perl-Software-License-CCpack - Software::License pack for Creative Commons' licenses
perl-Sort-Naturally - Sort::Naturally -- sort lexically, but sort numeral parts numerically
perl-Specio-Library-Path-Tiny - Path::Tiny types and coercions for Specio
perl-String-Util - String::Util -- String processing utilities
perl-Sub-Exporter-ForMethods - Perl module with helper routines for using Sub::Exporter
perl-Sub-Exporter-GlobExporter - export shared globs with Sub::Exporter collectors
perl-Sub-Exporter-Lexical - to export lexically-available subs with Sub::Exporter
perl-Sub-Exporter-Progressive - Sub::Exporter::Progressive - Only use Sub::Exporter if you need it
perl-System-Command - System::Command - Object for running system commands
perl-TAP-DOM - Accessors for TAP::DOM summary part
perl-Task - Task - successor to Bundle:: for installing sets of modules
perl-Template-Plugin-Autoformat - TT plugin for Text::Autoformat
perl-Template-Provider-DBIC - Template::Provider::DBIC - Load templates using DBIx::Class
perl-Template-Timer - Template::Timer - Rudimentary profiling for Template Toolkit
perl-Template-Tiny - Template::Tiny - Template Toolkit reimplemented in as little code as possible
perl-Term-UI - User interfaces via Term::ReadLine made easy
perl-Term-VT102 - Term::VT102 - a class to emulate a DEC VT102 terminal
perl-Term-VT102-Boundless - A L<Term::VT102> that grows automatically to
perl-Test-Block - Test::Block - Specify fine granularity test plans
perl-Test-Class-Most - Test::Class::Most - Test Classes the easy way
perl-Test-Deep-Fuzzy - fuzzy number comparison with Test::Deep
perl-Test-Deep-JSON - Perl module to compare JSON with Test::Deep
perl-Test-Distribution - Test::Distribution - perform tests on all modules of a distribution
perl-Test-Dynamic - Advanced automatic test counting for Test::More
perl-Test-Expect - Test::Expect - Automated driving and testing of terminal-based programs
perl-Test-HTTP-Server-Simple - Test::More functions for HTTP::Server::Simple
perl-Test-HexString - Test::HexString test binary strings with hex dump diagnostics
perl-Test-Memory-Cycle - A thin Test::More-compatible wrapper around Devel::Cycle module
perl-Test-Metrics-Any - assert that code produces metrics via L<Metrics::Any>
perl-Test-More-UTF8 - Enhancing Test::More for UTF8-based projects
perl-Test-Most - Test::Most - Most commonly needed test functions and features
perl-Test-Perl-Critic - Test::Perl::Critic - Use Perl::Critic in test programs
perl-Test-Script - Test::Script - Basic cross-platform tests for scripts
perl-Test-SharedFork - Test::SharedFork - fork test
perl-Test-TCP - Test::TCP - testing TCP program
perl-Test-Toolbox - Test::Toolbox - tools for testing
perl-Test-Trap - Test::Trap perl module
perl-Test-WWW-Mechanize - Test-WWW-Mechanize - Testing-specific WWW::Mechanize subclass
perl-Test-WWW-Mechanize-Catalyst - Test::WWW::Mechanize for Catalyst
perl-Test-WWW-Mechanize-PSGI - Test PSGI programs using WWW::Mechanize
perl-Text-CSV - Text::CSV - comma-separated values manipulation routines
perl-Text-FindIndent - Text::FindIndent - Heuristically determine the indent style
perl-Text-RecordParser - Text::RecordParser - read record-oriented files
perl-Text-SimpleTable - Text::SimpleTable - Simple Eyecandy ASCII Tables
perl-Text-TabularDisplay - Text::TabularDisplay - display text in formatted table output
perl-Text-TestBase - Parser for Test::Base format
perl-Text-WagnerFischer - Text::WagnerFischer is an implementation of the Wagner-Fischer edit distance in Perl.
perl-Text-Xslate-Bridge-TT2Like - Text::Xslate::Bridge::TT2Like - TT2 Variable Method Clone For Text::Xslate
perl-Tie-Array-QueueExpire - Tie::Array::QueueExpire - tie ARRAY over a TokyoCabinet::BDB database with expiration function
perl-Tie-CPHash - Tie::CPHash - Case preserving but case insensitive hash table
perl-Tie-RefHash-Weak - Tie::RefHash subclass with weakened references in the keys
perl-Tie-Sub - Tie::Sub - Tying a subroutine, function or method to a hash
perl-Tie-ToObject - Tie::ToObject - Tie to an existing object
perl-Tree-Simple-VisitorFactory - Tree::Simple::VisitorFactory - A factory object for dispensing Visitor objects
perl-Types-Path-Tiny - Path::Tiny types and coercions for Moose and Mo
perl-UNIVERSAL-can - Perl module UNIVERSAL::can
perl-UNIVERSAL-isa - Perl module UNIVERSAL::isa
perl-URI-Find - URI::Find - Find URIs in arbitrary text
perl-WWW-Blog-Identify - WWW::Blog::Identify - Identify blogging tools based on URL and content
perl-WWW-Yandex-TIC - WWW::Yandex::TIC - Query Yandex Thematic Index of Citing (TIC) for domain
perl-WordPress-Post - DEPRECATED see WordPress::CLI instead
perl-Wx-Perl-ProcessStream - Wx::Perl::ProcessStream - access IO of external processes via events
perl-X11-Protocol-Other - This is some miscellaneous extras and helpers for X11::Protocol
perl-XML-Compile-Tester - support XML::Compile related regression testing
perl-XML-Entities - XML::Entities - Decode strings with XML entities
perl-XML-LibXML-Simple - XML::LibXML based XML::Simple clone
perl-XML-SimpleObject - A simple object representation of a parsed XML::Parser tree
perl-XML-TokeParser - Simplified interface to XML::Parser
perl-XML-TreeBuilder - Parser that builds a tree of XML::Element objects
perl-XML-Writer-String - Capture output from XML::Writer
perl-YAML-PP-LibYAML - Faster backend for YAML::PP
perl-Mail-SpamAssassin - Mail::SpamAssassin - SpamAssassin e-mail filter libraries
perl-X2Go-Log - Perl X2Go::Log package
perl-X2Go-Server - Perl X2Go::Server package
